# In top 500 in overall corpus but not in top 2000 in core

κίνησις: movement, motion
ἐνέργεια: action, operation, energy
Χριστός: the anointed one, Christ
αἴσθησις: perception by the senses
γένεσις: an origin, source, productive cause
τουτέστι: that is to say
ἅγιος: devoted to the gods, sacred, holy
μόριον: a piece, portion, section
θερμός: hot, warm
σάρξ: flesh
φυσικός: natural, native
ὑγρός: wet, moist, running, fluid
συλλογισμός: computation
ψυχρός: cold, chill
ὁρισμός: a marking out by boundaries, limitation
Ἀριστοτέλης: Aristotle
στοιχεῖον: sound; element, principle
ἀπόδειξις: a shewing forth, exhibiting
αἰσθητός: perceptible by the senses
προφήτης: one who speaks for a God and interprets his will
ποιότης: quality
γραφή: drawing, writing; indictment
Πλάτων: Plato
ἐφεξῆς: in order, in a row, one after another
συμπέρασμα: a conclusion
σπέρμα: seed, offspring
ξηρός: dry
ἀντίκειμαι: to be set over against, lie opposite
λογικός: of or for speech, possessed of reason, intellectual
διάφορος: different, unlike
ἄτοπος: out of place
πέρας: an end, limit, boundary

# 501-600 in overall corpus but not in top 2000 in core

ψευδής: lying, false
ἀναγκαῖον: a place of constraint, a prison
βιβλίον: a paper, scroll, letter
ἕξις: a having, possession
χυμός: juice
πυρετός: burning heat, fiery heat
ἄλογος: without
διαίρεσις: a dividing, division
μῦς: the field-mouse, muscle, mussel
γαστήρ: the paunch, belly
χρῶμα: the surface, skin: the colour of the skin, the complexion
λέξις: a speaking, saying, speech
κυρίως: like a lord
κατηγορία: an accusation, charge
φλέψ: a vein
νόσημα: a sickness, disease, plague
σωτήρ: a saviour, deliverer, preserver
κοιλία: the large cavity of the body, the belly
λεπτός: (husked, threshed) fine, thin, delicate, subtle
ἐνεργέω: to be in action, to operate
ὡσαύτως: in like manner, just so
ἀπόστολος: a messenger, ambassador, envoy

# 601-700 in overall corpus but not in top 2000 in core

αἰών: life, lifetime, time; spinal marrow
κἄν: and if, even if, although
ὄργανον: an organ, instrument, tool, for making
θέσις: a setting, placing, arranging
γωνία: a corner, angle
ἀρτηρία: the wind-pipe
σελήνη: the moon
δηλονότι: quite clearly, manifestly, plainly
ἀπόφασις: a denial, negation
ἆ: ah!
ἠμί: to say
ἰδέα: form
μνημονεύω: to call to mind, remember
ἔλαιον: olive-oil
περισσός: beyond the regular number
Παῦλος: Paulus, Paul
Ἰωάννης: Johannes, John
μόριος: of burial
ποιητικός: capable of making, creative, productive
παράδειγμα: a pattern
φαντασία: imagination, the power by which an object is presented
φθορά: destruction, ruin, perdition
γνῶσις: a (judicial) inquiry, knowledge
τρίγωνος: three-cornered, triangular
περαίνω: to bring to an end, finish, accomplish, execute
Καῖσαρ: Caesar

# 701-800 in overall corpus but not in top 2000 in core

αὐτοκράτωρ: one's own master
ἐναργής: visible, palpable, in bodily shape
κακία: badness
γραμμή: the stroke
ἄνωθεν: from above, from on high
ἐπισκοπέω: to look upon
ἤ2: exclam.
διδασκαλία: teaching, instruction, education
Ἱπποκράτης: Hippocrates
σφυγμός: a throbbing of parts, pulsation, vibration
ἐλέγχω: cross-examine; put to the test; prove; refute
Μωυσῆς: Moses
ἁπλόω: to make single, to unfold, stretch out
σφοδρός: vehement, violent, excessive
νεῦρον: a sinew, tendon;
μέλι: honey
σύμμετρος: commensurate with
ὑγίεια: health, soundness
φιλοσοφία: love of knowledge and wisdom, pursuit thereof, speculation, study
μέσης: a wind between
νοητός: perceptible to the mind, thinkable
σύνθετος: put together, composite, compound
ἧ: (Cyr.) where
ἀστήρ: star
διορίζω: to draw a boundary through, divide by limits, separate
ἀΐδιος: everlasting, eternal
ἄτομος: uncut, unmown
νοσέω: to be sick, ill, to ail

# 801-900 in overall corpus but not in top 2000 in core

νοσέω: to be sick, ill, to ail
σκληρός: hard
ἄχρι: until, up to; (Hom.) to the uttermost, utterly
ἐνίοτε: sometimes
εὔλογος: having good reason, reasonable, sensible
πραγματεία: the careful prosecution of an affair, diligent study, hard work
μονάς: alone, solitary
οἴ: ah! woe!
εὐθεῖα: (γραμμή) straight line
κέντρον: any sharp point
σκοπός: one that watches, one that looks after
ὁμώνυμος: having the same name
πρόειμι: go forward
θερμότης: heat
στέρησις: deprivation, privation
βαδίζω: to go slowly, to walk
παχύς: thick, stout
θεωρία: a looking at, viewing, beholding
ἐπίσκοπος: one who watches over, an overseer, guardian
ἤγουν: that is to say, or rather
ἐνδείκνυμι: to mark, point out
δισσός: two-fold, double
θέρμος: lupine, Lupinus albus
πλάτος: breadth, width
φορά: a carrying
τῆ: take
παντελής: all-complete, absolute, complete, entire
ἀνάλογος: proportionate
δέρμα: the skin, hide

# 901-1000 in overall corpus but not in top 2000 in core

δάκτυλος: a finger
σύγκειμαι: to lie together
διδάσκαλος: a teacher, master
κρᾶσις: a mixing, blending, compounding
παρατίθημι: to place beside
ἄρτος: bread, loaf of bread
ἕλκος: a wound
ἰάομαι: to heal, cure
ὀδύνη: pain of body
θερμαίνω: to warm, heat
ἀκίνητος: unmoved, motionless
γνωρίζω: to make known, point out, explain
λύπη: pain of body
βάθος: depth
ἐέ: exclamation of pain or grief
φυτόν: that which has grown, a plant, tree
ῥίζα: a root
γνώριμος: well-known, familiar; the notables (opp. δῆμος)
ἐπιφάνεια: manifestation, visible surface
μετρέω: to measure in any way
κεφάλαιος: of the head
θεραπεία: a waiting on, service
ἀγγεῖον: vessel, reservoir
ῥητός: stated, specified
Ἀβραάμ: Abraham
τετράγωνος: with four equal angles, rectangular
τύπος: a blow
ἴς: sinew, tendon
κοῦφος: light, nimble
ἀκοή: a hearing, the sound heard