ὁ: the
καί: and, also
δέ: but
ὅς: who, that, which: relative pronoun
εἰμί: to be
αὐτός: unemph. 3rd pers.pronoun; -self; [the] same
οὗτος: this; that
μέν: on the one hand, on the other hand
τε: and
ἐν: in, among. c. dat.
ἐγώ: I (first person pronoun)
οὐ: not
εἰς: into, to c. acc.
τις: any one, any thing, some one, some thing;
γάρ: for
ὡς: as, how
σύ: you (personal pronoun)
ἐπί: on, upon with gen., dat., and acc.
λέγω: to pick; to say
πρός: (w. gen.) from; (w. dat.) at, near, in addition to; (w. acc.) to, toward, regarding
κατά: down, against with gen.; according to, throughout with acc.
ἐκ: from out of
πᾶς: all, the whole
ἀλλά: otherwise, but
ἔχω: to have
γίγνομαι: become, be born
πολύς: much, many
ἄλλος: other, another
περί: around, round about with gen., dat., and acc.
ὅς2: [possessive pronoun]
ἄν: modal particle
μή: not
ποιέω: to make, to do
δή: [interactional particle: S&amp;H on same page]
εἰ: conj. if, whether; part. w/wishes, adv. w/imperatives
γε: at least, at any rate
φημί: to say, to claim
διά: through c. gen.; because of c. acc.
ἀνήρ: a man
πόλις: a city
τῷ: therefore, in this wise, thereupon
παρά: from the side of, c. gen., beside, alongside of, c. dat., to the side of, motion alongside of, c. acc.
μέγας: big, great
μετά: (w gen) with, among; (w acc) after
ὑπό: from under, by, c. gen. under, c. dat., towards c. acc.
ὅτι: adv. + superl., as...as possible; ὅτι μή except
ὅτι2: conj.: that, because
πρότερος: before, earlier
οὖν: so, then, therefore
ἤ: either..or; than
ὅδε: this
οὐδέ: and/but not; not even
ἀπό: from, away from. c. gen.
ναῦς: a ship
νῦν: now at this very time
ἑαυτοῦ: himself, herself, themselves
ἐπεί: after, since, when
ἐάν: if
ἄρα: particle: &#39;so&#39;
θεός: god
σφεῖς: personal and (ind.) reflexive pronoun
ἐμός: mine
οὐδείς: not one, nobody
ὁράω: to see
ἐκεῖνος: that over there, that
δοκέω: seem, impers. it seems best..
πρῶτος: first
ἔρχομαι: to come
οὔτε: neither / nor
λόγος: the word
τίς: who? which?
δέω: to bind, tie, fetter
δέω2: to lack, miss, stand in need of
βασιλεύς: a king, chief
οὕτως: so, in this manner
τοιοῦτος: such as this
ὦ: O! oh!
ἔτι: yet, as yet, still, besides
οὗ2: him, her (οὗ οἷ ἕ)
τίη: why? wherefore?
δίδωμι: to give
εἶπον: to speak, say
λαμβάνω: to take, seize, receive
εἶμι: come, go
ὅσος: as much/many as
καλός: beautiful
σός: your
φίλος: friend; loved, beloved, dear
ἅμα: at once, at the same time
αὐτοῦ: at the very place, just here, just there
κακός: bad
τῇ: here, there
γῆ: earth
πόλεμος: battle, fight, war
παῖς: a child
Ζεύς: Zeus
βούλομαι: to will, wish, be willing
τότε: at that time, then
οἶδα: to know
ἄνθρωπος: man, person, human
οἷος: (such a kind) as; for οἷός τε see οἷος III.2
ἕκαστος: every, every one, each, each one
ἤδη: already
δεῖ: it is necessary
χείρ: the hand
ἄγω: to lead
πατήρ: a father
Ἀθήναιος: Athenaeus
εἷς: one
φέρω: to bear
τοτέ: at times, now and then
αἴρω: to take up, raise, lift up
Ἕλλην: Hellen; Greek
Ἀχαιός: Achaian
μόνος: alone, left alone, forsaken solitary
Ῥωμαῖος: a Roman
ὥστε: so that
Λακεδαίμων: Lacedaemon
χρόνος: time
πείθω: to prevail upon, win over, persuade
ἀκούω: to hear
μάλιστα: most
τοι: let me tell you, surely, verily
γυνή: a woman
πάρειμι: be present
ποτε: ever, sometime
αἱρέω: to take, (mid.) to choose
ἦ: in truth, truly, verily, of a surety
καλέω: to call, summon
ἔργον: work
ἡμέρα: day
δύναμις: power, might, strength
ἀρχή: a beginning, rule, office, empire
μιν: him, her, it
πολέμιος: hostile; enemy
δύναμαι: to be able, capable, strong enough
Λακεδαιμόνιος: Spartan
μᾶλλον: more, rather
ἄρχω: (to be first) to rule, to begin
ἀείρω: to lift, heave, raise up
ὑπέρ: over, above, w. gen, over, beyond, w. acc.
ἀεί: always, for ever
ἀτάρ: but, yet
χώρα: land
καιρός: time; the right moment, opportunity
πρᾶγμα: that which has been done, a deed, act
φαίνω: to bring to light, make to appear
ἵνα: in order that (conj.); where (rel. adv.)
μέλλω: to think of doing, intend to do, to be about to do
πράσσω: do, (w. adv) fare, (mid.) charge payment
τίθημι: to set, put, place
υἱός: a son
πως: somehow, in some way
ἐθέλω: to will, wish, purpose
ὅτε: when
ἀλλήλων: of one another, to one another, one another
ἔπειτα: then, next
θυμός: the soul
ἀφικνέομαι: to come to
οἴομαι: to suppose, think, deem, imagine
ἕτερος: the one; the other (of two)
συμβαίνω: meet, agree, happen
ἵππος: a horse, mare
θάλασσα: the sea
ἵστημι: to make to stand
πλείων: more, larger
ποταμός: a river, stream
εἶδον: to see
σύν: along with, in company with, together with
ἅπας: quite all, the whole
ἀγαθός: good
πέμπω: to send, despatch
κελεύω: to urge
περ: precisely; w. pple. even though (later καίπερ)
μάλα: very, very much, exceedingly
σύμμαχος: fighting along with, allied with
μέρος: a part, share
στρατηγός: the leader
τόπος: a place
ὥσπερ: just as if, even as
νομίζω: to have as a custom; to believe
ἔνθα: there
πάλιν: back, backwards
ἀποθνῄσκω: to die, be killed
τυγχάνω: (with gen.) to hit the mark, to get; (with pple) to happen to, to actually
μήν: now verily, full surely
μηδείς: (and not one); not one, no-one
πῶς: how? in what way
ὅστις: indef. relative or indirect interrogative
Πέρσης: a Persian; Perses (pr.n.)
δίκαιος: just, observant of custom, correct, balanced
χράομαι: use, experience
ἵημι: to set a going, put in motion
ταχύς: quick, swift, fleet
ἀνά: up, upon
διό: wherefore, on which account
ἔοικα: to be like; to look like
εὐθύς: straight, direct
εὖ: well
μένω: to stay at home, stay where one is, not stir
Ἀθηναῖος: Athenian, of Athens
ἔπος: a word
ἄρον: cuckoo-pint, Arum italicum
μάχη: battle, fight, combat
ὑμός: your
ὅπως: how, that, in order that, as
πάσχω: to experience, to suffer
Ὀδυσσεύς: Odysseus
Καρχηδών: Carthage
πλῆθος: a great number, a throng, crowd, multitude
γιγνώσκω: to learn to know, to perceive, mark, learn
τρόπος: a turn, direction, course, way; character
βάλλω: to throw
τροπός: a twisted leathern thong
ὀλίγος: few, little, scanty, small
φεύγω: to flee, take flight, run away
πλεῖστος: most, largest
νύξ: the night
προαγορεύω: to tell beforehand
χράω2: proclaim an oracle, (rare) furnish; mid.: consult an oracle, lend
μήτε: neither / nor
δεινός: fearful, terrible, dread, dire
ἱππεύς: a horseman
ὑπάρχω: to begin; to exist
λοιπός: remaining, the rest
ἀμφότερος: each of two, both
ἴδιος: one&#39;s own, pertaining to oneself
ἀμφί: on both sides
Ἀθήνη: Athena
πρίν: before; (after negated main clause) until
Καρχηδόνιος: Carthaginian
ὅμοιος: like, resembling
μηδέ: but not
χρῆμα: thing, (pl.) goods, property, money
τεῖχος: a wall
ἡγέομαι: to lead; to consider, believe
πούς: a foot
χράω: to fall upon, attack, assail
ἴσος: equal to, the same as; adv. perhaps
ΑΒΓ: ABC and any other geometric figure
καθίστημι: to set down, place
τοσοῦτος: so large, so tall
Πελοπόννησος: the Peloponnesus
Τρώς: Tros
αὖ: again, anew, afresh, once more
ἠδέ: and
κεῖμαι: to lie; to have been set/put (as perf. pass. of τίθημι)
εὑρίσκω: to find
πυνθάνομαι: to learn by hearsay
που: anywhere, somewhere
γνώμη: a means of knowing, a mark, token
αὖθις: back, back again
ὄνομα: name
νομός: place of pasture; district (nome), esp. in Egypt
ἐναντίος: opposite
κοινός: common, shared in common
μήτηρ: a mother
ὅλος: whole, entire, complete in all its parts
ὁρμάω: to set in motion, urge
ὁδός: a way, path, track, journey
πρό: before
Ἀργεῖος: of/from Argos, Argive
βαίνω: to walk, step
ἑταῖρος: a comrade, companion, mate
ἥκω: to have come, be present, be here
ψυχή: breath, soul
καθά: according as, just as
ἱερός: super-human, mighty, divine, wonderful
παρέχω: to furnish, provide, supply
στρατόπεδον: the ground on which soldiers are encamped, a camp, encampment
μάχομαι: to fight
νόμος: usage, custom, law, ordinance
βιός: a bow
μέσος: middle, in the middle
νέος: young, youthful
ἕπομαι: follow
πλέω: to sail, go by sea
ξένος: a guest, guest-friend, stranger; foreign
Ἑλλάς: Hellas
χρή: it is fated, necessary
βίος: life
Φίλιππος: Philip, Philippus
ἄριστος: best
νέα: fallow land (LSJ νειός)
ὅταν: when, whenever
βάρβαρος: barbarous
λείπω: to leave, quit
οὗ: where
ἕνεκα: on account of, for the sake of, because of, for
κρατέω: to be strong, mighty, powerful
φρήν: the midriff; heart, mind
νῆσος: an island
νικάω: to conquer, prevail, vanquish
ἐρῶ: [I will say]
βουλεύω: to take counsel, deliberate, concert measures
δέχομαι: to take, accept, receive
Ἀθῆναι: the city of Athens
τέλος: the fulfilment
ἐάω: to let, suffer, allow, permit
χάρις: gratitude, favor, grace, charm
στρατιά: army
πειράω: to attempt, endeavour, try
ἀληθής: unconcealed, true
φύσις: the nature, natural qualities, powers, constitution, condition
τρεῖς: three
καῖρος: the row of thrums
δῆμος: people; (originally) a country-district, country, land
πρέσβυς: an old man; pl. ambassadors
ἀνάγκη: force, constraint, necessity
ὀρθός: straight
πεζός: on foot
ἀπόλλυμι: to destroy, kill; to lose
μέντοι: however, nevertheless; of course (answers)
ἔτος: a year
μανθάνω: to learn
γαῖα: a land, country
αὐτίκα: forthwith, straightway, at once
Αἰτωλός: Aetolian
δημός: fat
μῦθος: anything, delivered by word of mouth, word, speech
οἶκος: a house, abode, dwelling
δείκνυμι: to show
τοιόσδε: such a
κίνδυνος: a danger, risk, hazard, venture, enterprise
ἐφίστημι: to set on, over; set in charge of
οἰκέω: to inhabit, occupy
πρᾶξις: a doing, transaction, business
ἐλπίς: hope, expectation
πίπτω: to fall, fall down
παραγίγνομαι: to come near, attend upon
Ἕκτωρ: Hector
δείδω: to fear
στρατός: an encamped army
τάσσω: to arrange, put in order
ὅπλον: a tool, implement, (pl.) arms, weapons
ἱκνέομαι: to come
διαφθείρω: to destroy, ruin; to corrupt
ὧδε: in this wise, so, thus
ἐνταῦθα: here, there; at that juncture
ὄρος: a mountain, hill
σῶμα: the body
Κῦρος: Cyrus
νόος: mind, perception
γένος: race, stock, family
ἄξιος: worthy
ζήω: to live (LSJ ζῶ)
ὄφρα: in order that; as long as, until
παρασκευάζω: to get ready, prepare
δῖος: god-like, divine; (trag.) Δῖος &quot;of Zeus&quot;
πλήν: except
κρίνω: to pick out, choose, judge, determine
τρέπω: to turn
αὖτε: again
πάνυ: altogether, entirely
ἥλιος: the sun
ὕδωρ: water
κενός: empty
ἐλαύνω: to drive, drive on, set in motion
πεδίον: a plain
βοηθέω: to come to aid, to succour, assist, aid
πατρίς: fatherland, homeland; of one’s father
δεύτερος: second
Ἀχιλλεύς: Achilles
πορεύω: to make to go, carry, convey
ἑκάτερος: each of two, either, each singly
λύω: to loose
δόρυ: tree, plank, spear
δυνατός: strong, mighty, able
μικρός: small, little
ἀφίστημι: to put away, remove; (mid.) revolt
Συράκουσαι: Syracuse
ἄναξ: a lord, master
διότι: for the reason that, since
ἀφίημι: to send forth, discharge
δίκη: (custom, usage) justice, lawsuit, penalty
δῶμα: a house
ταύτῃ: in this way.
πῦρ: fire
οἰκεῖος: in or of the house
χορός: a round dance
προσαγορεύω: to address, greet, accost
ῥᾴδιος: easy, ready, easy to make
ἀξιόω: to think worthy of; to expect
ἀρετή: goodness, excellence
ἀθάνατος: undying, immortal
ἀποδίδωμι: to give back, give what is due; (mid.) sell
ὁρμέω: to be moored, lie at anchor
παρακαλέω: to call to
ἀδικέω: to do wrong
κομίζω: to take care of, provide for
αἰτία: a charge, accusation
σῴζω: to save, keep
στρατεύω: to serve in war, serve as a soldier, do military service, take the field, march
ἱκανός: becoming, befitting, sufficing
τέκνον: a child
κεφαλή: the head
οὔκουν: not therefore, so not
ᾗ: which way, where, whither, in
μακρός: long
φράζω: to point out, shew, indicate
ἡμέτερος: our
οὐκοῦν: therefore, then, accordingly
ἀναγκάζω: to force, compel
λανθάνω: to escape notice, to be unknown, unseen, unnoticed
χωρίον: a particular place, a place, spot, district
μέχρι: until (prep. and conj. w. aor.), as long as (conj. w. pres.)
θυγάτηρ: a daughter
δύω: dunk
βοῦς: cow
λαός: the people
οὐκέτι: no more, no longer, no further
τίκτω: to bring into the world
Περσεύς: Perseus
θεά: a goddess
ὅστε: who, which
στρατιώτης: a citizen bound to military service;
φυλάσσω: to keep watch and ward, keep guard
πολεμέω: to be at war
θάνατος: death
στράτευμα: an expedition, campaign
τελευτάω: to complete, finish, accomplish; pple. finally, in the end
ὁμολογέω: agree, say the same thing as
καταλαμβάνω: to seize upon, lay hold of
παραδίδωμι: to hand over, to surrender
βραχύς: short
χραύω: to scrape, graze, wound slightly
δῆλος: visible, conspicuous
ὁμῶς: equally, likewise, alike
μέγαρον: a large room
δόμος: a house; a course of stone
πιστεύω: to trust, trust to
ἕως: (w. aor or as prep.) until; (w. pres) as long as
ἔθνος: a number of people accustomed to live together, a company, body of men
γράφω: to scratch, draw, write
ὅμως: all the same, nevertheless
βία: bodily strength, force, power, might
γέρων: an old man (in apposition as adj., old)
Δαρεῖος: Darius
παύω: to make to cease
ἀδελφός: sons of the same mother
δράω: to do
πρεσβευτής: an ambassador
φύω: to bring forth, produce, put forth
τεύχω: to make ready, make, build, work
Πελοποννήσιος: Peloponnesian (of people)
πλέως: full of
χρύσεος: golden, of gold, decked
δόξα: a notion
Σικελία: Sicily
κατέχω: to hold fast
ὕστερον: the afterbirth
χαίρω: to rejoice, be glad, be delighted
τρέφω: to nourish, rear, maintain
καθό: in so far as, according as
καταλείπω: to leave behind
Ἀσία: Asia
ἀμύνω: to keep off, ward off
ὄρνυμι: to stir, stir up
Συρακόσιος: Syracusan
Μακεδών: a Macedonian
φιλέω: to love, regard with affection
κτείνω: to kill, slay
Αἰγύπτιος: Egyptian
ἀγών: a gathering; a contest, a struggle, a trial
δέκα: ten
Ἀπόλλων: Apollo
ἆρα: particle introducing a question
Ξέρξης: Xerxes
ἀποκτείνω: to kill, slay
ἐχθρός: hated, hateful; enemy
φρονέω: to think, to have understanding, to be sage, wise, prudent
Αἰτωλία: Aetolia
τιμάω: to honor; to value something at a price (gen.)
εἴτε: whether..or (regardless of whether A or B)
ἑτοῖμος: at hand, ready, prepared
διαφέρω: to carry through; be different from, excel
Κορίνθιος: Corinthian
ποῖος: of what nature? of what sort?
κόρη: a maiden, maid; pupil of the eye
τύχη: (good) fortune, luck, chance
Αἴγυπτος: Egypt (f.); king Aegyptus (m.)
τρίτος: the third
διαβαίνω: to cross (a river, etc.); to stand with feet apart
συμμαχία: an alliance offensive and defensive
εἴκοσι: twenty
παραπλήσιος: coming near, nearly resembling, such-like
ἐλάσσων: smaller, less
Σωκράτης: Socrates
Ἄρης: Ares
χαλκοῦς: a copper coin
πρόσθεν: before
δύο: two
ἐγγύς: near, nigh, at hand
φοβέω: to put to flight, to terrify; mid. to fear
σκοπέω: to look at
μιμνήσκω: to remind
ἱερόν: sanctuary
ἄνεμος: wind
ἐπιβολή: a throwing
ἐπιτήδειος: suitable; useful, necessary; deserving; associate
φόβος: fear, panic, flight
ἄστυ: a city, town
ἀντί: over against, opposite. c. gen.
ἀμείβω: change, alternate, respond
ἐντεῦθεν: hence
τιμή: that which is paid in token of worth
ἦμαρ: day
νεκρός: a dead body, corpse
νέμω: to deal out, distribute, dispense
ἡγεμών: leader, guide
Σάμος: Samos
ἥσσων: less, weaker
Ἀννίβας: Hannibal
σχεδόν: close, near, hard by, nigh
σαφής: clear, plain, distinct, manifest
πολιτεία: citizenship, citizen body, constitution
τρέω: to flee from fear, flee away
στάδιον: a stade, = ca. 600 feet
Ἀντίοχος: Antiochus
παραλαμβάνω: to receive from
ἔρως: love
πέντε: five
χαλεπός: hard to bear, painful; difficult
ἀνίστημι: to make to stand up, raise up
δῶρον: a gift, present
ἔξω: out
χρεία: use, advantage, service
ὀφθαλμός: the eye
θύω: to sacrifice
σύγκλητος: called together, summoned
ὁπλίτης: heavy-armed, armed
ὁπότε: when
ναυτικός: seafaring, naval
ἠώς: the morning red, daybreak, dawn
χθών: the earth, ground
βασιλεία: a kingdom, dominion
οὐρανός: heaven
οἴχομαι: to be gone, to have gone
οἰκία: a building, house, dwelling
ἄγε: come! come on! well!
σφέτερος: their own, their
κέρας: the horn of an animal
ποιός: of a certain nature, kind
Αἴας: Ajax
εὔχομαι: to pray, offer prayers, pay one&#39;s vows, make a vow
Ῥώμη: Roma, Rome
δηλόω: to make visible
τοίνυν: therefore, accordingly
ἀποδείκνυμι: display, appoint, demonstrate
πύλη: one wing of a pair of double gates
πολιορκέω: to hem in a city, blockade, beleaguer, besiege
τελέω: to complete, fulfil, accomplish
ἀσφαλής: not liable to fall, immoveable, steadfast, firm
ἀποκρίνω: to separate, set apart; mid. answer
θύω2: rage, seethe
οἶνος: wine
πόντος: the sea
ἀλήθεια: truth
χαλκός: copper
συνίστημι: to set together, combine, associate, unite, band together
ἥρως: hero
χωρέω: give way, draw back, retire, withdraw
ἀγορά: an assembly of the people
παρασκευή: preparation
φυλακή: a watching
τολμάω: to undertake, take heart
συμφέρω: to bring together; impers. to benefit
δεῦρο: hither
θαυμάζω: to wonder, marvel, be astonished
ἔπειμι2: (go) come upon, approach, attack
ἐνθάδε: here, in this place, at this point
χίλιοι: a thousand
πίστις: trust, belief; pledge, security
ἀναχωρέω: to go back
ἔγχος: a spear, lance
συμβάλλω: to throw together, dash together
ἀπαλλάσσω: to set free, release, deliver
αἴτιος: to blame, blameworthy, culpable
Μέγαρα: town of Megara
ἑός: his, her own
σοφός: wise, skilled, clever
κῆρυξ: a herald, pursuivant, marshal, public messenger
πολλάκις: many times, often, oft
ἐσθίω: to eat
τάξις: an arranging
ἑκατόν: a hundred
Ξενοφῶν: Xenophon
πόνος: work
ὄλλυμι: to destroy, make an end of
πω: up to this time, yet
τέσσαρες: four
βροτός: a mortal man
κύων: a dog
ὀξύς2: sharp, keen
χειμών: winter; storm, stormy weather
πλοῖον: a floating vessel, a ship, vessel
διδάσκω: to teach
δεξιός: on the right hand
θεωρέω: to look at, view, behold
αἰσχρός: causing shame, abusive
μέλας: black, swart
Λιβύη: Libya, the north part of Africa
διώκω: to pursue
ἄπειμι2: go away
μοῖρα: a part, portion; fate
τάλαντον: a balance
Τηλέμαχος: Telemachus
ἐπαινέω: to approve, applaud, commend
μέγεθος: greatness, magnitude, size, height, stature
σῖτος: corn, grain
ἄνευ: without
ἀπολείπω: to leave over
στόμα: the mouth
κτάομαι: to procure for oneself, to get, gain, acquire
ῥέω: to flow, run, stream, gush
κινδυνεύω: to be daring, to make a venture, take the risk, do a daring thing
μνηστήρ: a wooer, suitor
Σκύθης: a Scythian
ἡδύς: sweet
ὠκύς: quick, swift, fleet
τέχνη: art, skill, craft in work, cunning of hand
πολίτης: (fellow) citizen
ὅσπερ: the very man who, the very thing which
ἀπέχω: to keep off
ἄλλως: in another way
ὥρα2: time, season, climate
ὀπίσω: backwards
Ἰησοῦς: Joshua; Jesus
Ἴωνες: Ionians
ἔπειμι: be there (in addition, later, set over)
ἐπιβάλλω: to throw
οἶος: alone, lone, lonely
κουρά: a shearing
ζητέω: to seek, seek for
συνεχής: holding together
παρίστημι: to make to stand
δαίμων: god; divine power
θεῖος: of/from the gods, divine
νοέω: to perceive by the eyes, observe, notice
προσπίπτω: to fall upon, strike against
ἄδικος: wrong-doing, unrighteous, unjust
ἀμείνων: better, abler, stronger, braver
ἀποστέλλω: to send off
πάλαι: long ago, in olden time, in days of yore, in time gone by
ἄρχων: a ruler, commander, chief, captain
Ἰταλία: Italy
ὥρα: [sacrificial victim]
πρόσφημι: to speak to, address
Βοιωτός: a Boeotian
θύρα: a door
ἐπέρχομαι: come near; come upon; attack
βοή: a loud cry, shout
μυρίος: numberless, countless, infinite
ἤπειρος: terra-firma, the land
ἀδύνατος: unable, impossible
εἰσέρχομαι: to go in
Ἀτρείδης: son of Atreus
χωρίς: separately, asunder, apart, by oneself
αἷμα: blood
θεάομαι: to look on, gaze at, view, behold
ἐσθλός: good
ἀφεστήξω: I shall be absent, away from
φωνέω: to produce a sound
μεταξύ: betwixt, between
στῆθος: the breast
ἐκπέμπω: to send out
ὄψις: look, appearance, aspect
πορεία: a walking, mode of walking
ἐκεῖ: there, in that place
παραγγέλλω: to transmit as a message; give orders
Ἥρα: Hera
ἴσως: equally, in like manner
φανερός: open to sight, visible, manifest, evident
ἁλίσκομαι: to be caught, conquered, caught in the act
εὐρύς: wide, broad
κρείσσων: stronger, mightier, more powerful
σπονδή: drink-offering; (pl.) truce, treaty
Ῥόδιος: Rhodian, of or from Rhodes
ὑπολαμβάνω: take up; understand, interpret; assume; reply, rejoin
ἀναβαίνω: to go up, mount, to go up to
ἑξῆς: one after another, in order, in a row
συμφορά: an event, circumstance, chance, hap
βαρύς: heavy
ἕνος: belonging to the former of two periods, last year&#39;s
θέα: a seeing, looking at, view
μένος: might, force, strength, prowess, courage
ἀναγκαῖος: necessary, forcible (subst. kin, necessities for life)
ἐμβάλλω: to throw in, put in
θαρσέω: to be of good courage, take courage
ὦμος: shoulder (with the upper arm)
ἀγορεύω: to speak in the assembly, harangue, speak
ὑπεναντίος: set over against, meeting
αἰσθάνομαι: to perceive, apprehend by the senses, to see, hear, feel
ἐπιτίθημι: to lay, put on; (mid.) to attack
ἄνω: to accomplish, achieve, finish
Μενέλαος: Menelaos
ἀφαιρέω: to take from, take away from
τεῦχος: a tool, implement
πέλω: to be, become; Hom. be in motion
ἔνδον: in, within, in the house, at home
χάλκεος: of copper
πίνω: to drink
βασίλεια: a queen, princess
λιμήν: a harbour, haven, creek
διέρχομαι: to go through, pass through
ὄρνις: a bird
ἐργάζομαι: to work, labour
κλύω: to hear
θοός: quick, nimble
ὁρμή: a violent movement onwards, an assault, attack, onset
ἐπιγίγνομαι: to be born after, come into being after
Ἄργος: Argos
δαμάζω: to overpower, tame, conquer, subdue
παλαιός: old in years
ἐξαποστέλλω: to send quite away Pass.
εἶδος: that which is seen, form, shape, figure
ἀποπέμπω: to send off
κόσμος: order
κύριος: having power
κωλύω: to let, hinder, check, prevent
βρότος: blood that has run from a wound, gore
τέλειος: having reached its end, finished, complete
Δάφνις: Daphnis
χῶρος: a piece of ground, ground, place
ἅτε: just as (both pre-and postposed); w. part.: because
βλάπτω: to disable, hinder (Hom.); to harm, damage
τύραννος: an absolute sovereign
ἐπιχειρέω: to attempt, attack, put one’s hand to
χέω: to pour
νέω: to swim
ᾍδης: Hades
Πτολεμαῖος: Ptolemy
βοάω: to cry aloud, to shout
τριάκοντα: thirty
ἀπέρχομαι: to go away, depart from
οὐδαμός: not even one, no one
εἶτα: then, next
προάγω: to lead forward, on, onward
σπουδή: haste, speed
βλέπω: to see, have the power of sight
ἀσπίς: a round shield
πότερος: which of the two?
κρατερός: strong, stout, mighty
ἀνάγω: to lead up; mid. set sail
ἄγγελος: a messenger, envoy
φάσκω: to say, affirm, assert
λίθος: a stone
Ἀγαμέμνων: Agamemnon, lit. the very steadfast
αἶψα: quick, with speed, on a sudden
ἐρωτάω: to ask
τοῖος: quality, such, such-like
ἄπειμι: be absent
χρυσός: gold
ὅρκος: the object by which one swears, the witness of an oath
τριακόσιοι: three hundred
βουλή: will, determination; council, senate
ἐξέρχομαι: to go out, come out
ἐκτός: outside
καθόλου: on the whole, in general
μείγνυμι: to mix, mix up, mingle, properly of liquids
μέλω: to be an object of care
σημαίνω: to shew by a sign, indicate, make known, point out
πεντήκοντα: fifty
αἰτέω: to ask, beg; postulate
φωνή: a sound, tone
Πολύβιος: Polybius
σύμπας: all together, all at once, all in a body
Πύλαι: Thermopylae
Μῆδος: a Mede, Median
ναυμαχία: a sea-fight
ἐντός: within, inside
ἁμαρτάνω: to miss, miss the mark
ἄνω2: up, upwards
ἄρτι: just now, recently
προστίθημι: to add, to apply, to close (a door); mid. to join (a group), take as an ally
καταβαίνω: to step down, go
ἕλκω: to draw, drag
ἐπίσταμαι: to know
τόξον: a bow
φιλία: friendly love, affection, friendship
θέω: to run
Θηβαῖος: Theban
αἴξ: a goat
πέτρα: a rock, a ledge
Κροῖσος: Croesus
Ἡρακλέης: Heracles
ὕπνος: sleep, slumber
ἔρδω: to do
ἡδονή: delight, enjoyment, pleasure
ἀνέχω: to hold up; (mid.) endure, put up with
σωτηρία: a saving, deliverance, preservation, safety
νέω3: to heap, pile, heap up
τάχα: (Homer, later rare) quickly, presently; (post-Homer) perhaps
δῆτα: certainly, to be sure, of course
λίμνη: a pool of standing water; a lake
ἐρύω: to drag along the ground, drag, draw
πρόθυμος: ready, willing, eager, zealous
νιν: him, her
Ἀλέξανδρος: Alexander
κινέω: to set in motion, to move
ἅπτω: to fasten, bind fast; mid. touch
ὀργή: natural impulse
ὕστερος: latter, last
θηρίον: a wild animal, beast
ἀποδέχομαι: to accept from
προσαυδάω: to speak to, address, accost
καίτοι: and indeed, and further; and yet
εἰσοράω: to look into, look upon, view, behold
τεός: = σός, &#39;your&#39;
ἐράω: to love, to be in love with
Κλεομένης: Cleomenes
προσδέχομαι: to receive favourably, accept
βασιλεύω: to be king, to rule, reign
βέλος: projectile; arrow, weapon
θνητός: liable to death, mortal
συνάγω: to bring together, gather together, collect, convene
φόνος: murder, homicide, slaughter
ἀποβαίνω: to step off from
ζάω: to live
ὑπομένω: to stay behind, survive
ἀπαλλαξείω: to wish to be delivered from
στόλος: an expedition; a voyage; equipment
ἵζω: to make to sit, seat, place
τόσος: so great, so vast
γόνυ: the knee
ἀναλαμβάνω: to take up, take into one&#39;s hands
εἴσω: to within, into
ἅλς2: sea
κράτος: strength, might
χλόη: the first shoot of plants
φάος: light, daylight
ἕζομαι: to seat oneself, sit
ὁμοῦ: at the same place, together
Πόπλιος: Publius
πιστός2: to be trusted
ἔξεστι: it is allowed, it is in one&#39;s power, is possible
τέμνω: to cut, hew
ὀνομάζω: to name
συνθήκη: a composition
Φοῖνιξ: a Phoenician
ἐμπίπτω: to fall in
διασαφέω: to make quite clear, shew plainly
συμμείγνυμι: mix together, commingle
Ποσειδῶν: Poseidon
ναίω: to dwell, abide
φώς: a man
ἁμός: our, my &gt; ἐμός
Μεσσήνιος: of Messene
τέρπω: to satisfy, delight, gladden, cheer
ἐκβάλλω: to throw
ἡσσάομαι: to be less than another, inferior to
εἰρήνη: peace, time of peace
Σπάρτη: Sparta
ἐξάγω: to lead out
Ὄλυμπος: Olympus
ἄνωγα: to command, order
συλλέγω: to collect, gather
σπεύδω: to set a-going, to urge on, hasten, quicken
δεσπότης: a master, lord, the master of the house
ὅθεν: from where, whence
προτίθημι: to place before, to propose, to prefer
λόφος: the back of the neck
ναός: the dwelling of a god, a temple
διαλύω: to loose one from another, to part asunder, undo
Θῆβαι: Thebes (usu. plural)
ἐρῆμος: desolate, lone, lonely, lonesome, solitary
ἐπιθυμέω: to set one&#39;s heart upon
μετέχω: to partake of, enjoy a share of, share in, take part in
προσέχω: to hold to, offer
Πάτροκλος: Patroclus
ποιητής: one who makes, a maker
ἄμφω: both
ἐλπίζω: to hope for, look for, expect
ἔτης: clansmen
φύλαξ: a watcher, guard, sentinel
κῦμα: anything swollen
δάκρυον: a tear
ἀποπλέω: to sail away, sail off
νύμφη: a young wife, bride
ἔφοδος: accessible
πυκνός: close, compact
μισθός: wages, pay, hire
Τισσαφέρνης: Tissaphernes
διαφορά: difference, distinction
ἀσφάλεια: security against stumbling
ζέω: to boil, seethe
προστάσσω: to order
ἔρομαι: to ask, enquire
ποῦ: where
ἡλικία: time of life, age
δικαιοσύνη: righteousness, justice
μείς: a month
πλόος: a sailing, voyage
ἑπτάς: period of seven days
ἔνειμι: to be in; to be possible
συγχωρέω: to come together, meet
προαίρεσις: a choosing
ἐνίστημι: to put, set, place in
ἧμαι: to be seated, sit
ἰσχυρός: strong, mighty
ἄκρα: a headland, foreland, cape
προσήκω: to have come; to belong to, to fit
Δαναοί: the Danaans
προΐστημι: set before
Πρίαμος: Priam
διακόσιοι: two hundred
τίνω: to pay a price
ἀπάγω: to lead away, carry off
ἐφίημι: to send to; (mid) to long for
κόλπος: bosom; gulf
ἀναιρέω: to take up; to destroy
ἀείδω: to sing
θέρος: summer, summertime; harvest, crop
καθήκω: to have come; to suit, to belong to, be one’s duty
ὀφείλω: to owe, have to pay
Θρᾷξ: a Thracian;
Ὅμηρος: Homer
ὑμέτερος: your, yours
ἑκών: willing, of free will, readily
προσφέρω: to bring to
βιάζω: to constrain
ἐλεύθερος: free
πρόκειμαι: to be set before one
προΐημι: send forth, send forward; abandon
ἀλλότριος: of/belonging to another
ἤτοι: now surely, truly, verily
Ἠλεῖος: from Elis
ὅπου: where
ἑπτά: seven
πάρος: beforetime, formerly, erst
στρατοπεδεύω: to encamp, bivouac, take up a position
καίω: to light, kindle
ἄκρος: at the furthest point
ἁρμόζω: to fit together, join
ὠφελέω: to help, aid, assist, to be of use
τελευταῖος: last
ἔστε: up to the time that, until
ὅμιλος: any assembled crowd, a throng of people
τίω: to pay honour to
γλῶσσα: the tongue
κύκλος: a ring, circle, round
ἱστορία: a learning by inquiry, inquiry
ὄπισθεν: behind, at the back
φυγή: flight
εἴπερ: strengthd. for εἰ, if indeed
σταθμός: a standing place, weight
ὑπισχνέομαι: to promise
συντίθημι: to put together
γάμος: a wedding, wedding-feast
ἔφοδος3: a way towards, approach
ὄχλος: a moving crowd, a throng, mob
λευκός: light, bright, clear
ἅρμα: a chariot
τάχος: swiftness, speed, fleetness, velocity
ἥκιστος: least
ἡσυχία: stillness, rest, quiet
εἰσβάλλω: to throw into, put into
Δελφοί: Delphi; Delphians
ἐπιβαίνω: to go upon
ἅλς: a lump of salt
ἀθροίζω: to gather together, to muster
παρίημι: to pass over, let go, relax, yield, allow
ἐμαυτοῦ: of me, of myself
ἀχεύω: grieving, sorrowing, mourning
φάλαγξ: a line of battle, battle-array
ὀτρύνω: to stir up, rouse, egg on, spur on, encourage
ἐπιτρέπω: to turn over to, entrust, command
βελτίων: better
ὄμμα: the eye
παράδοξος: contrary to opinion, incredible, paradoxical
συνάπτω: to tie
αὐδάω: to utter sounds, speak
λίαν: very, exceedingly
ἄκων2: against one&#39;s will &gt; ἀέκων
εἴδομαι: are visible, appear
κάθημαι: to be seated
κίω: to go
νή: (yes) by..
μά: (no,) by ..
κάρα: the head
δοῦλος: slave
πέλαγος: the sea
εἴωθα: to be accustomed
ἐξελαύνω: to drive out from
ἀριθμός: number
διανοέομαι: to be minded, intend, purpose
μεθίημι: to let go, let loose, release
ἆθλος: a contest for a prize
Σπαρτιάτης: a Spartan
ἀέκων: against one&#39;s will, unwilling
Περικλῆς: Pericles
Ἑλλήσποντος: the Hellespont
εἰκός: like truth
παρέρχομαι: to go by, beside
τηρέω: to watch over, protect, guard
κάμνω: to work, toil, be sick
Ἑλληνικός: Hellenic, Greek
μέμονα: to wish eagerly, to yearn, strive, be fain
οὐδαμῶς: in no wise
ἐφορεύω: to be ephor
οἴκαδε: to one&#39;s home, home, homewards
εὔνοια: good-will, favour, kindness
νόσος: sickness, disease, malady
ναί: yea, verily
κύριος2: a lord, master
ἱκάνω: to come, arrive
ἐλευθερία: freedom, liberty
τεσσαράκοντα: forty
ὄμνυμι: to swear
διαφεύγω: to flee through, get away from, escape
χείρων: worse, meaner, inferior
Σάρδεις: Sardes
πτερόεις: feathered, winged
σεαυτοῦ: of thyself
πρέπω: to be clearly seen, to resemble, to seem (πρέπει it is fitting)
νίκη: victory
ἐμέω: to vomit, throw up
καταπλήσσω: to strike down
αἰνός: dread, dire, grim
ἐγείρω: to awaken, wake up, rouse
φορέω: to bear
χάραξ: a pointed stake
Μακεδονία: Macedon
γλυκύς: sweet
ῥέζω: to do, act, deal; (Dor.) dye
βωμός: any raised platform, a stand
πόσις: a husband, spouse, mate
πρόθεσις: a placing in public
κώμη: country town
διαιρέω: to take one from another, to cleave in twain, to divide into parts
ὀξύς: wood sorrel, Oxalis Acetosella
ἀγνοέω: not to perceive, be ignorant of
καρπός: fruit
ἥμισυς: half
Θρᾴκη: Thrace
Ἀττικός: Attic, Athenian
ὅσιος: hallowed, sanctioned by the law of God
ἐπιφανής: coming to light, appearing; remarkable, distinguished
λᾶας: stone
προσβάλλω: to strike
τριήρης: trireme
ὑποδείκνυμι: to shew secretly
πορεῖν: have offered, given
προσάγω: to bring to
ἐκπίπτω: to fall out of
χαρίζω: to do a favor, to oblige, to please
συμβουλεύω: to advise, counsel
πάντῃ: every way, on every side
ὅρος: a boundary, landmark
κλαίω: to weep, lament, wail
μισθοφόρος: receiving wages
τροφή: nourishment, food, victuals
ἐπιφέρω: to bring, put
τόλμα: courage, to undertake
μῆλον2: tree-fruit
Εὐρώπη: Europa, Europe
πεντακόσιοι: five hundred
μῆλον: a sheep
Σάμιος: of Samos
χρώς: the surface of the body, the skin
παρεμβολή: insertion, interpolation
ἐοικότως: similarly, like
αὐξάνω: to make large, increase, augment
Δημήτριος: of Demeter, (pr.n.) Demetrius
νέομαι: to go
ἐφέζομαι: to sit upon
καίπερ: although, albeit
θάπτω: to bury, to honour with funeral rites
πολιορκία: a besieging, siege
διάνοια: a thought, intention, purpose
ἐπέχω: to hold on; hold out; hold back; adjourn; occupy
ἐνιαυτός: year
ἴσχω: to hold, check, curb, keep back, restrain
παραχρῆμα: on the spot, forthwith, straightway
πλέος: full.
ψεύδω: to cheat by lies, beguile
καρδία: the heart
ἔνθεν: whence; thence
γοῦν: at least then, at any rate, any way
χῶρος2: north-west wind
ἐράω2: [to pour out, vomit forth]
εἰκότως: in all likelihood, suitably, fairly, reasonably, naturally
ἀντίον2: part of the loom
ἀνίημι: to send up; let go, abate
οὕνεκα: on which account, wherefore
πληρόω: to make full
ἄλοχος: a bedfellow, spouse, wife
ἀνάσσω: to be lord, master, owner, to rule, in
πύργος: a tower
Λύκιος: Lycian; (fem. noun) Lycia
Καμβύσης: Cambyses
Κελτοί: the Kelts
τάφρος: a ditch, trench
πρόφασις: that which is alleged as the cause, an allegation, plea
Χίος: Chios (island)
δαίς: feast
χρηστός: useful, good of its kind, serviceable
ἀρχαῖος: from the beginning
Μιλήσιος: Milesian
Ἄτταλος: Attalus
μεταβολή: a change, changing
τλάω: to take upon oneself, to bear, suffer, undergo
ἀγγέλλω: to bear a message
φθάνω: to come or do first, before others
κλισία: a place for lying down
ἄψ: backwards, back, back again
διαλέγω: to pick out one from another, to pick out
ἐξαιρέω: to take out of
καταλύω: to put down, destroy; settle (disputes); lodge, rest
κάλλος: beauty
ἐξουσία: power
εἴκω: give way
ὁλοσχερής: whole, entire, complete
στενός: narrow, strait
συντάσσω: to put in order together
κατοικέω: to settle; to inhabit
ἐπιτελέω: to complete, finish, accomplish
Εὐμένης: Eumenes
μιμέομαι: to mimic, imitate, represent, portray
διάλυσις: a loosing one from another, separating, parting
πρόσω: forwards, onwards, further
ὅθι: where
ἰσθμός: neck, narrow passage
ἀδικία: injustice
ἀποχωρέω: to go from
εὐδαίμων: fortunate, wealthy, happy
πρεσβεύω: to be the elder; to be an ambassador
ἀλκή: strength
ἔνιοι: some
γενεά: race, stock, family
πρόσωπον: the face, visage, countenance
οὔπω: not yet
στέφανος: that which surrounds
ὕλη: wood, material
ὕπατος: supremus, the highest, uppermost; Roman consul
σεύω: to put in quick motion: to drive, hunt, chase away
ἐκφέρω: to carry out of
Τροία: Troy
ἕξ: six
λαγχάνω: to obtain by lot, by fate, by the will of the gods
ὅπη: by which way
σημεῖον: a sign, a mark, token
τύπτω: to beat, strike, smite
Ἀλκιβιάδης: Alcibiades
συνίημι: to bring together; understand
πολεμικός: of or for war; skilled in war; hostile
ποιμήν: herdsman, shepherd
Κόρινθος: Corinth, (masc) Korinthos son of Zeus, founder of Corinth
καταστρέφω: to turn down, trample on
βέβαιος: firm, steady, steadfast, sure, certain
Νέστωρ: Nestor
ἐκλείπω: to leave out, omit, pass over
γενναῖος: noble, excellent
ἄλγος: pain
ἀπαμείβομαι: to reply, answer
ὠφέλεια: help, aid, succour, assistance
Ἰβηρία: Iberia: area near Causasus, or current-day Spain
ἔργω: to bar one&#39;s way
εἰσάγω: to lead in
εὐνή: a bed
σφάλλω: to make to fall, throw down, overthrow
στρατηγέω: to be general
Ἴλιος: Ilian, Trojan
Λυδός: (adj) Lydian; (subst) Lydus, their mythical ancestor
Πύλος: Pylos
ἀραρίσκω: to join, join together, fasten
Λίβυς: a Libyan
ἀπαντάω: to meet
τῆλε: at a distance, far off, far away
Μίλητος: Miletus
ἀπολύω: to loose from
κέλομαι: to urge on, exhort, command
ἐπιτάσσω: to put upon one as a duty, to enjoin
ἀπολιμπάνω: to leave
ἀμύμων: blameless, noble, excellent
ὀκτώ: eight
Σύριος: Syrian
ἀπορία: difficulty of passing
δισχίλιοι: two thousand
δηϊόω: cut down, slay
μέλος: a limb; a phrase of song; a song
καλύπτω: to cover with
Μαρδόνιος: Mardonius
ἀληθινός: agreeable to truth
ἐρύω2: protect, guard
ὕβρις: wantonness, wanton violence
ἀπαγγέλλω: to bring tidings, report, announce
πέλας: near, hard by, close
ὗς: wild swine
ὄλεθρος: ruin, destruction, death
ὑψηλός: high, lofty, high-raised
συμμαχέω: to be an ally, to be in alliance
ἀστός: a townsman, citizen
ἀργύριον: a piece of silver, a silver coin
θρόνος: a seat, chair
Χῖος: Chian (inhabitant of Chios)
ἔσχατος: outermost
Οἰδίπους: Oedipus
προγίγνομαι: to come forwards
παντάπασι: all in all, altogether, wholly, absolutely
βοήθεια: help, aid, rescue, support
καθίζω: to make to sit down, seat
ἁρπάζω: to snatch away, carry off
ἄλλῃ: in another place, elsewhere
καταλέγω: recount, tell at length and in order
Διόνυσος: Dionysus
στάσις: a standing, the posture of standing
κάτω: down, downwards
πατρῷος: of or belonging to the father
Μοῦσα: the Muse
διάθεσις: a disposition, arrangement
ἀπορέω2: to be at a loss
πρόβατον: sheep; small cattle
ξύλον: wood
καθοράω: (to look down); to observe
τέταρτος: fourth
σπουδάζω: to make haste
πλήσσω: to strike, smite
Θεσσαλός: Thessalian
ἀνατίθημι: dedicate, refer
ἀγρός: fields, lands
λέων: a lion
κατηγορέω: to speak against, to accuse
ἀΐω: perceive
δόλος: a bait, trap, cunning
παρθένος: a maid, maiden, virgin, girl
χρήσιμος: useful, serviceable, good for use, good, apt
αἰχμάλωτος: taken by the spear, captive to one&#39;s spear, taken prisoner
πάθος: anything that befalls one, an incident, accident
ἀθρόος: in crowds
μάντις: one who divines, a seer, prophet
αὖθι: on the spot, here, there
ἐπείγω: to press down, weigh down; mid. hasten
στρατεία: an expedition, campaign
αὐτόθι: on the spot
ἄγριος: (living in the fields) wild, savage, harsh
σοφία: skill
δυναστεία: power, lordship, sovereignty
Ἄρατος: Aratus
κοῖλος: hollow, hollowed
ἀΐσσω: shoot, dart, glance
Αἰγινήτης: an Aeginetan (Αἴγινα)
ἀγωνίζομαι: to contend for a prize
ἦτορ: the heart
ἄγνυμι: to break, shiver
μῆκος: length
θείνω: to strike, wound
ἀκμή: a point, edge
δίφρος: the chariot (board); seat
θάλαμος: an inner room
Σεύθης: Seuthes
κλυτός: heard of: renowned, famous
μάκαρ: blessed, happy
ἄγαλμα: a glory, delight, honour; a cult statue
τιμωρέω: to help, aid, succour
κατασκευή: preparation
νέκυς: a dead body, a corpse, corse
ἐντέλλω: to enjoin, command
κῆρ: the heart
ἀοιδή: song, a singing
κατατίθημι: to place, put
Ἑλένη: Helen
ἐφέπω: to go after, follow, pursue
ἐπίκειμαι: lie on, to be closed, to lie nearby (off the coast of)
ποικίλος: many-coloured, spotted, mottled, pied, dappled
γῆρας: old age
νόστος: a return home
δεῖπνον: the principal meal
πολιτικός: of, for, related to citizen or statesman; civil, constitutional
ἁπλόος: single, simple
προσδέω2: to need besides
κρύπτω: to hide, cover, cloak
ἐπαγγέλλω: to tell, proclaim, announce
λίσσομαι: to beg, pray, entreat, beseech
πελταστής: one who bears a light shield
συγγενής: born with, congenital, natural, in-born
ὀπάζω: to make to follow, send with
διάβασις: a crossing over, passage
Γαλάτης: Celt
καθαιρέω: to take down
δύη: woe, misery, anguish, pain
Ἀρκάς: Arcadian
διαπέμπω: to send off in different directions, send to and fro, send about
περιγίγνομαι: to be superior to; to survive
αὐλή: court
ἐπιστήμη: knowledge, skill
πονέω: to work hard, do work, suffer toil
βλώσκω: to go
κρέας: flesh, meat, a piece of meat
φυγάς: one who flees, exile, fugitive
Φοῖβος: Phoebus
προθυμία: readiness, willingness, eagerness, zeal
ἐπιβουλεύω: to plot against
παραυτίκα: immediately, forthwith, straightway
ἐπάγω: to bring on
ἦθος: custom, character
εἷμα: a garment
ῥίπτω: to throw, cast, hurl
ἀποφαίνω: to shew fort, display, produce
προσλαμβάνω: to take or receive in addition
παιδίον: a child
θυσία: burnt offering, sacrifice
αὔτως: in this very manner, even so, just so, as it is
ἀντέχω: to hold out against, withstand
Βορέας: North wind
ὑπερβάλλω: to throw over
ξίφος: a sword
πλοῦτος: wealth, riches
μέτριος: within measure
Ἑρμῆς: Hermes
ἐλευθερόω: to free, set free
ἐπιδείκνυμι: to exhibit as a specimen
κάρτα: very, very, much, extremely
πεῖρα: a trial, attempt, essay, experiment
θέμις: that which is laid down
εὐώνυμος: of good name, left
προδίδωμι: to give beforehand, pay in advance; to betray, surrender
Θεσσαλία: Thessaly
ἀκτή: headland, foreland, promontory
σπένδω: to pour a libation, (mid.) to make a treaty
πρόσειμι2: approach
ἐνέπω: to tell, tell of, relate, describe
οὐδέποτε: never
διατίθημι: to place separately, arrange
προοράω: to see before one, to take forethought
ναυμαχέω: to fight in a ship
φιλότης: friendship, love, affection
ποθεν: from some place
διάκειμαι: to be in a certain state, to be disposed
κῦδος: glory, renown
ἐκδίδωμι: to give up, surrender
παρουσία: a being present, presence
νῶτον: the back
πόρω:  pres. not attested; aor. to furnish, offer; perf. it is fated
ἐκπλήσσω: (to knock out); to astound, shock, amaze
ἀγείρω: to bring together, gather together
κέλευθος: a road, way, path, track
χιτών: the garment worn next the skin, a frock
μνήμη: a remembrance, memory, record
συλλαμβάνω: to collect, gather together
αἵρεσις: a taking especially
κατάγω: to lead down
Κερκυραῖος: of Corcyra, Corfu
πιέζω: to press, squeeze; oppress, distress
βέλτιστος: best
πάντως: altogether;
ἐντυγχάνω: to light upon, fall in with, meet with
ὄϊς: sheep
ἀντιλέγω: to speak against, gainsay, contradict
μυριάς: a number of ten thousand, myriad
προσέρχομαι: to come
δημόσιος: belonging to the people
βόα: fish
φαεινός: shining, beaming, radiant
μηχανάομαι: to prepare, make ready
Ἀφροδίτη: Aphrodite
γλαυκῶπις: with gleaming eyes, brighteyed
ὑστεραῖος: on the day after, the next day
ἄτη: bewilderment, infatuation, reckless impulse
ἄλλοτε: at another time, at other times
λήγω: to stay, abate
μέτρον: that by which anything is measured
Ἥφαιστος: Hephaestus, god of fire
θεράπων: a waiting-man, attendant
ἑξήκοντα: sixty
γράμμα: (drawing, scratch) letter, character, writing, document
τυραννίς: kingly power, sovereignty
πικρός: pointed, sharp, keen
Ἀντίγονος: Antigonus
νεανίσκος: a youth
κλέος: a rumour, report; fame, glory
Πόντος: Pontus
σφός: their, their own, belonging to them
περίστασις: a standing round, a crowd standing round
ὀϊστός: arrow
μηκέτι: no more, no longer, no further
γέρας: a gift of honour
διατρίβω: to rub between, rub hard, rub away, consume, waste
κατασκευάζω: to equip
πίμπλημι: to fill full of
ὑπέχω: to hold under, uphold; undergo, suffer, be accountable
ἐκπλέω: to sail out, sail away, weigh anchor
ἀγλαός: splendid, shining, bright, beautiful
ἐπαίρω: to lift up and set on
δένδρον: a tree
νομάς: roaming about for pasture
ἐσθής: dress, clothing, raiment
πείρω: to pierce quite through, fix
φαῦλος: slight, indifferent, trivial, common, simple
πλησίος: near, close to
φιλάνθρωπος: loving mankind, humane, benevolent, kindly
ἀντίος: set against
ὑπερβολή: a throwing beyond
Συρία: Syria
ἐπιθυμία: desire, yearning, longing
μαίνομαι: to rage, be furious
συνέρχομαι: come together, meet
γέφυρα: a dyke, dam
ἀγγελία: a message, tidings, news
Δημοσθένης: Demosthenes
κοινωνέω: to have or do in common with
συναθροίζω: to gather together, assemble
σύνειμι: be with (incl. be wife of, study with)
ἐμπίμπρημι: to kindle, burn, set on fire
τάφος: a burial, funeral
τηλικοῦτος: of such an age, of such a magnitude
ἑορτή: a feast
ἐπικρατέω: to rule over
παραινέω: to exhort, recommend, advise
ἄχος: pain, distress
ἐπίκουρος: an assister, ally
πελάζω: to approach, come near, draw near
χόλος: gall, bile
τοιγάρ: so then, wherefore, therefore, accordingly
Λοκρός: Locrian
δρόμος: a course, running, race
κράτιστος: strongest, mightiest
προσδέω: to bind on
χάριν: for the sake of, because of (postposition + gen.)
γαμέω: to marry
Ἀκαρνάν: Acarnan, Acarnania
Μεγαρεύς: a citizen of Megara
τραγῳδία: a tragedy
σκηνή: a covered place, a tent
ἐπιπλέω: to sail upon
πηγή: running waters, streams
πήγνυμι: to make fast
κλίνω: to make to bend, slope; recline
περιίστημι: to place round
ἕννυμι: to put clothes on
στήλη: a block of stone
συμπίπτω: to fall together, meet in battle, come to blows
ὑποδέχομαι: to receive, entertain; to promise
ἀρέσκω: (to make good, make up), to please
ἱδρύω: to make to sit down, to seat
τετρακόσιοι: four hundred
ψηφίζω: (mid.) to vote; (act.) to count with pebbles
ἐλάχιστος: the smallest, least
χιλίαρχος: the commander of a thousand men, a chiliarch
νεώτερος: younger
πότνια: mistress, queen
Ὀλύμπιος: Olympian, of Olympus, dwelling on Olympus
ὅμηρος: a pledge for the maintenance of unity, a surety, a hostage
Χαλκιδεύς: Chalcidian, of Chalcis
ἐγγίγνομαι: to be born or bred in; be innate, be native
τρίς: thrice, three times
ἔλπω: to make to hope
ἰώ: oh!
εἴρω: to fasten together in rows, to string
πορθέω: to destroy, ravage, waste, plunder
Κλέαρχος: Clearchus
περίειμι: be superior, survive, be left over
Δίη: Dia
κορυφή: the head, top, highest point;
Βρασίδας: Brasidas
ἔρις: strife, quarrel, debate, contention
ἐκεῖθεν: from that place, thence
Δίον: Dion
οὖς: auris, the ear
ἐπικαλέω: to call upon
ἐπανέρχομαι: to go back, return
περιοράω: to look over, overlook
γελάω: to laugh
τείνω: to stretch
μόλις: barely, scarcely
Ἰωνία: Ionia
πρόνοια: foresight, foreknowledge
λαμπρός: bright, brilliant, radiant
ὑπόθεσις: proposal, subject, supposition
ὑφίστημι: to place under; mid. to submit, to promise
ἆθλον: the prize of contest
κοσμέω: to order, arrange
ἔξειμι: go out
ἀήρ: the lower air, the air
ἀμφίπολος: busied about, busy
εὔζωνος: well-girdled
Ἴβηρ: Iberian
θεραπεύω: to be an attendant, do service
κήδω: to trouble, distress, vex; mid. care for
στασιάζω: to rebel, revolt, rise in rebellion
ἀκρόπολις: the upper city
κρατήρ: a mixing vessel
φθείρω: to ruin, waste, spoil, destroy
διαπράσσω: to pass over; bring about, accomplish
πέτομαι: to fly
δεσμός: anything for binding, a band, bond
μεταπέμπω: to send after
βαθύς: deep
ζῷον: a living being, animal
σάκος: a shield
ἐξηγέομαι: to be leader of
Νικίας: Nicias
ὁπότερος: which of two, whether of the twain
ὁπόσος: as many as
πλήρης: filled
ἐξευρίσκω: to find out, discover
σῆμα: a sign, mark, token
σφόδρα: very, very much, exceedingly, violently
ἥδομαι: to enjoy oneself, take delight, take one&#39;s pleasure
καταφεύγω: to flee for refuge
πάρειμι2: go past, march along, come forward
λόχος: an ambush
πῆμα: suffering, misery, calamity, woe, bane
πλευρά: a rib
Κρής: a Cretan
Γνάιος: Gnaeus
θαυμαστός: wondrous, wonderful, marvellous
Λεύκιος: Lucius
ἄκρον: the highest or furthest point: mountain top, cape
ἔμπεδος: in the ground, firm-set, steadfast
ἐπώχατο: were kept shut
ἐξίημι: to send out, let
λοχαγός: the leader of an armed band; commander of a company
ἀναφέρω: to bring up, bring back
ὅπῃ: where
διαλέγομαι: talk
βόειος: of an ox
θῆλυς: female
ἀμφισβητέω: to stand apart; disagree, dispute
ψιλός: bare, stripped; (soldier) without heavy armor, light troops
ἡσυχάζω: to be still, keep quiet, be at rest
ἀτρεκής: real, genuine
προβαίνω: to step on, step forward, advance
νήπιος: infant, childish
Μαντινεύς: of Mantinea, Mantinean
ἔξοδος: a going out; an exit
κτῆμα: anything gotten, a piece of property, a possession
ἀκολουθέω: to follow
χορηγία: office or λῃτουργία of a χορηγός
ὑπόκειμαι: to lie under
κέρδος: gain, profit, advantage
Φαίαξ: a Phaeacian
πλούσιος: rich, wealthy, opulent
ἀφορμή: a starting-point
διαβάλλω: to throw over
μηχανή: an instrument, machine
ἀσθενής: without strength, weak, feeble, weakly
πόρος: a means of passing/providing, provision
τράπεζα: four-legged a table
πολεμόω: to make hostile, make an enemy of
περάω: to drive right through; pass, penetrate
ἄγνοια: want of perception, ignorance
ὁποῖος: of what sort
Αἰήτης: Aeetes, son of Helius and Perse
δειλός: cowardly, craven
θάσσων: quicker, swifter
γλαφυρός: hollow, hollowed
τιμωρία: help, aid, assistance, succour
μεταβάλλω: to throw into a different position, to turn quickly
ὀλοός: destroying, destructive, fatal, deadly, murderous
ἡγεμονία: a leading the way, going first
ἀκριβής: exact, accurate, precise, made
Παλλάς: Pallas
Τίτος: Titus
ὦκα: quickly, swiftly, fast
μισέω: to hate
θρασύς: bold, spirited, courageous, confident
Σαλαμίς: Salamis
λυγρός: sore, baneful, mournful
δέος: fear, alarm
λούω: to wash
Ἰλλυριοί: Illyrians
χρηστήριον: an oracle
τρισχίλιοι: three thousand
φοιτάω: to go to and fro, up and down, to stalk
πειράζω: to make proof
ὑποζύγιον: a beast for the yoke, a beast of burden
ἐκβαίνω: to step out of
εὕδω: to sleep, lie down to sleep
ἀπαγορεύω: to forbid; to give up, renounce
φήμη: a voice from heaven, a prophetic voice
ὁμολογία: agreement
Εὔβοια: Euboea
στρέφω: to turn about
λυπέω: to give pain to, to pain, distress, grieve, vex, annoy
ἐξαπατάω: to deceive
στρατοπεδεία: encampment
Κρονίων: son of Cronus
ἀπιστέω: to disbelieve, distrust; to disobey
ὄχος: a carriage, shelter
κατακτείνω: to kill, slay, murder
Αἰνείας: Aeneas
οὐτάω: to wound, hurt, hit
οὔτις: no one
λέχος: a couch, bed
σκέπτομαι: to look about, look carefully
πληγή: a blow, stroke
χολόω: to make angry, provoke, anger
ἀνοίγνυμι: to open
τοσόσδε: so strong, so able
τοκεύς: one who begets, a father
ἐκκλησία: an assembly of the citizens regularly summoned, the legislative assembly
εἰσφέρω: to bring in, to propose (a question, a law), to pay tax (εἰσφορά)
καταστρατοπεδεύω: to put into cantonments, encamp
καθύπερθε: from above, down from above
πονηρός: toilsome, painful, grievous
διαβολή: false accusation, slander, calumny
γυμνός: naked, unclad
Δωριεύς: a Dorian, descendant of Dorus
πολύμητις: of many counsels
καθαρός: clear of dirt, clean, spotless, unsoiled
πόθεν: whence? (i.e., from where?)
παραπλέω: to sail by
πανταχόθεν: from all places, from all quarters, on every side
θαῦμα: whatever one regards with wonder, a wonder, marvel
καταδύω: to go down, sink, set
ὑπολείπω: to leave remaining
κρίσις: a separating, power of distinguishing
αἰδέομαι: to be ashamed to do
Βαβυλών: Babylon
εἰσβολή: an inroad, invasion, attack
ὁμιλέω: to be in company with, consort with
συνοράω: to see together
πέπνυμαι: to have breath
στέλλω: to set in order, to arrange, array, equip, make ready
χειρίζω: handle, manipulate
ζεύγνυμι: to yoke, put to
πρόσειμι: be there (in addition)
περιβάλλω: to throw round
αἰθήρ: ether, the brighter purer air, the sky (f. in Hom.; m. Attic)
ἀρκέω: to ward off; to be sufficient
ἀεικής: unseemly, shameful
Ἀλκίνοος: Alcinous
Ἰθάκη: Ithaca
ἱερεύς: a priest, sacrificer
Ἀσδρούβας: Hasdrubal
φάρμακον: a drug, medicine
ἀναγιγνώσκω: to know well, know certainly; to read
τάλας: suffering, wretched
Διομήδης: Diomedes (Zeus-counselled)
ἑσπέρα: evening, eventide, eve
φόρος: tribute, payment
Πηνελόπεια: Penelope
ἄρσην: male
ἄκων: a javelin, dart
ἔμπροσθεν: before, in front
ἀργύρεος: silver, of silver
Παυσανίας: Pausanias
συνέδριον: a body of men assembled in council, a council-board, council
μεταλλάσσω: to change, alter
ὁρίζω: to divide
βασίλειος: of the king, kingly, royal
δαιμόνιος: of or belonging to a δαίμων; miraculous, marvellous
Ἄρτεμις: Artemis
ἐγχειρέω: to put one&#39;s hand in
μαθητής: a learner, pupil
ἐντολή: an injunction, order, command, behest
αὐχήν: the neck, throat
σθένος: strength, might
κόρος2: young man
δυώδεκα: twelve
Χειρίσοφος: Chirisophus
Πλαταιεύς: inhabitant of Plataeae, Plataean
προεῖπον: to tell
ὄσσα: a rumour
ὀστέον: bone
καταφρονέω: to think down upon
ὀδύρομαι: to lament, bewail, mourn for
νέφος: a cloud, mass
μεταφωνέω: to speak among
γόος: weeping, wailing, groaning, howling, mourning, lamentation
ἀπελαύνω: to drive away, expel from
ἰσχύς: strength
εἴσειμι: to go into
εὐφυής: well-grown, shapely, goodly
ὀρέγω: to reach, stretch, stretch out
δέμας: the (physical frame, form of the) body
μουσικός:  musical, skilled in music, elegant
νοστέω: to come
τέμενος: a piece of land cut off, assigned as a domain
παρατάσσω: to place side by side, draw up in battle-order
ἐπιχώριος: in or of the country, local, native
ἰδιώτης: a private person, an individual
κατέρχομαι: to go down from; return from exile
μῆτις: wisdom, counsel, cunning, craft
ἄρουρα: tilled or arable land, ground, fatherland
ἐρύκω: to keep in, hold back, keep in check, curb, restrain
καταπλέω: to sail down
ἀπολαμβάνω: to take away, receive one’s due, cut off
συστρατεύω: to make a campaign
λεία: tool for smoothing stone
ἐφίζω: to set upon
Ὠκεανός: Oceanus
σεμνός: revered, august, holy, awful
ἐκεῖσε: thither, to that place
ἄθλιος: winning the prize, struggling, wretched
βοείη: an ox-hide, ox-hide shield
προέρχομαι: to go forward, go on, advance
περιέχω: to encompass, embrace, surround
λογισμός: a counting, reckoning, calculation, computation
Γλαύκων: Glaucon
δυσχερής: hard to take in hand
ἠέ: ah!
οἰκέτης: a house-slave, menial
μυθέομαι: to say, speak
ἐλύω: to roll round
πάτριος: of one’s father, ancestral, native
ὄσσε: the two eyes
κτίζω: to found
κήρ: doom, death, fate (LSJ Κήρ)
ἐπιστολή: a message, command, commission
γεννάω: to beget, engender
ἀντιάζω: to meet face to face
ζωή: a living
φαίδιμος: shining
ταράσσω: to stir, stir up, trouble
μέμφομαι: to blame, censure, find fault with
Φωκεύς: a Phocian
ἀργαλέος: painful, troublous, grievous
οὖρος: a fair wind
Ἰδομενεύς: Idomeneus, (‘strength of Ida’)
ποθι: anywhere
οὐσία: that which is one&#39;s own, one&#39;s substance, property
ἀγαπάω: to treat with affection, to caress, love, be fond of
δοξάζω: to think, imagine, suppose, fancy, conjecture
ῥήγνυμι: to break, break asunder
κόπτω: to strike, smite, knock down
ἔθος: custom, habit
ὄνειρος: a dream
προτείνω: to stretch out before, hold before
φθέγγομαι: to utter a sound
ἐτάζω: to examine, test
ὠθέω: to thrust, push, shove, force onwards
νεῖκος: a quarrel, wrangle, strife
παραλείπω: to leave on one side, leave remaining
συγγραφεύς: one who collects and writes down historic facts, an historian
ἔξωθεν: from without
σχῆμα: form, figure, appearance
ἵκω: to come to
λεία2: booty, plunder
λαλέω: to talk, chat, prattle, babble
παιδεύω: to bring up
σώφρων: of sound mind
καταβάλλω: to throw down, overthrow
Δημήτηρ: Demeter
ἀναζεύγνυμι: to yoke again
εὖτε: when, at the time when
ἐπιλαμβάνω: to lay hold of, seize, attack
ἄσμενος: well-pleased, glad
γείνομαι: to be born; to beget
πρόγονος: a forefather, ancestor
Κόλχος: a Colchian
ἄπειρος: without trial, inexperienced
χαμαί: on the earth, on the ground
ἐπιμελέομαι: to take care of, have charge of, have the management of
καινός: new, fresh
πανδημεί: with the whole people, in a mass
συγγνώμη: forgiveness
κόρος: one&#39;s fill, satiety, surfeit
ἁνδάνω: to please, delight, gratify
παντοῖος: of all sorts
οἴμοι: ah me! woe&#39;s me!
ἀρείων: better, stouter, stronger, braver, more excellent
φιλόσοφος: a lover of wisdom
ἑτοιμάζω: to make ready, prepare
ἰατρός: one who heals, a mediciner, physician
αἰσχύνω: to make ugly, disfigure, mar
μίμνω: to stay, stand fast
ἀνύω: to effect, achieve, accomplish, complete
ἐγκρατής: in possession of power
Ἀχαία: epithet of Demeter, Achaea
πρεσβεία: age, seniority; embassy
παίω: to strike, smite
τειχίζω: to build a wall
φοβερός: fearful
κρείων: a ruler, lord, master
Κρονίδης: son of Cronus
αἰχμή: the point of a spear
λογίζομαι: to count, reckon, calculate, compute
τόφρα: up to
χωρίζω: to separate, part, sever, divide
Μάρκος: Marcus
πνεῦμα: a blowing
ὅρκιον: an oath
Κρήτη: Crete
πώποτε: ever yet
μηρός: the thigh
κρήνη: a well, spring, fountain
Μάγος: a Magus, Magian
οὐρός: a trench
ἁμαρτία: a failure, fault, sin
Ἀγησίλαος: Agesilaus, lit. leader of people, conductor of men
μεγάθυμος: high-minded
Γάϊος: Gaius
συντελέω: to bring quite to an end, complete, accomplish
ἐξεργάζομαι: to work out, make completely, finish off, bring to perfection
παίζω: to play like a child, to sport, play
ἐννοέω: to have in one&#39;s thoughts, to think, consider, reflect
στυγερός: hated, abominated, loathed
μεθίστημι: to place in another way, to change
ζωός: alive, living
ῥύομαι: to draw to oneself
Ἄμασις: Amasis
ἱκέτης: one who comes to seek protection, a suppliant
σκῆπτρον: a staff
σής: a moth
ἐφοράω: to oversee, observe, survey
πολιός: gray, grizzled, grisly
πολίτευμα: the business of government, an act of administration
ἐγχειρίζω: to put into one&#39;s hands, entrust
προέχω: to hold before, to pretend; to jut out, to excel
οἰωνός: a large bird, bird of prey
ῥῆμα: (spoken) word, line, verb
νόσφι: aloof, apart, afar, away
συνέχω: to hold or keep together, secure; mid. to be afflicted
πέραν: on the other side, across, beyond
ἰός: an arrow
Μεσσήνη: Messene
Πολυκράτης: Polycrates
ἔχθρα: hatred, enmity
Αἰθίοψ: burnt-face
Νεῖλος: the Nile
διάστημα: an interval
ἀδελφή: a sister
βίοτος: life
φθίω: to decay, wane, dwindle
φροντίζω: to think, consider, reflect, take thought, have a care, give heed
διασῴζω: to preserve through
αἶσα: share, portion
προκαταλαμβάνω: to seize beforehand, preoccupy
αἰδώς: a sense of shame, shame, modesty, self-respect
ἐπιτέλλω: to lay upon, enjoin, prescribe, ordain, command
μαλακός: soft
κασίγνητος: a brother; adj of a brother; sibling
ἀπόκρισις: a separating; a reply
ἄνθος: a blossom, flower
Ἡρακλείδης: son of Heracles
σῦριγξ: a pipe
στερέω: to deprive, bereave, rob of
τέκος: the young
ῥόος: a stream, flow, current
συβώτης: a swineherd
ἀπόστασις: a standing away from
παράπαν: altogether, absolutely
καρτερός: strong, staunch, stout, sturdy;
δόγμα: that which seems to one, an opinion, dogma
συχνός: long
διπλόος: twofold, double
ταραχή: trouble, disorder, confusion
Προυσίας: Prusias
ἱστορέω: to inquire into
ὑποτίθημι: to place under, to suggest
νίζω: to wash the hands
βασιλικός: royal, kingly
προφανής: shewing itself
κράς: the head
γέλοιος: causing laughter, laughable
μετέωρος: raised from the ground, hanging
δηρός: long, too long
ἀμελέω: to have no care for, be neglectful of
δημοκρατία: democracy, popular government
κῆδος: care for
ἐνδέχομαι: to take upon oneself; to be possible
ῥεῖθρον: that which flows, a river, stream
κοιμάω: to lull
ταῦρος: a bull
διαφερόντως: differently from, at odds with
Αἶσα: the goddess of destiny
πολιά: grayness of hair
προπάροιθε: before, in front of
κονία: dust, a cloud of dust
περιπίπτω: to fall around, so as to embrace
κιχάνω: to reach, hit
Μυτιληναῖος: of Mytilene
δαπάνη: outgoing, cost, expense, expenditure
θόρυβος: a noise, uproar, clamour
ὑποχείριος: under the hand, in hand
καθέζομαι: to sit down, take one&#39;s seat
συνεργέω: to work together with, help in work, cooperate
κάματος: toil, trouble, labour
πέμπτος: the fifth, oneself with four others
μάρτυς: a witness
εἰκάζω: to make like to, represent by a likeness, portray
Λακωνικός: Laconian
ἡνίκα: at which time, when
σημεία: military standard
ἰχθύς: a fish
Αἴγινα: Aegina
μάρναμαι: to fight, do battle
οἰκίον: house, palace (always plural)
δαίνυμι: to divide
ἄλκιμος: strong, stout
δωρεά: a gift, present
ἄγχι: near, nigh, close by
φονεύω: to murder, kill, slay
μόρος: man&#39;s appointed doom, fate, destiny
Πάν: Pan
τανύω: to stretch, strain, stretch out
ὀρύσσω: to dig
γεραιός: old
δίς: twice, doubly
διακρίνω: to separate one from another
ἐπιτήδευμα: a pursuit, business, practice
ψεῦδος: a falsehood, untruth, lie
ἀριστερός: left, on the left
εὐδαιμονία: prosperity, good fortune, wealth, weal, happiness
πάροιθε: before, in the presence of
πτερόν: feathers
οἰκίζω: to found as a colony
Ἀγάθων: Agathon
σίδηρος: iron
πρόσκειμαι: to be placed at, by; to be attached to, devoted to
ἐπίνοια: a thinking on
σύνοιδα: to share in knowledge, be cognisant of
πραγματικός: fit for business, active, business-like;
γυῖον: a limb
θήρ: a wild beast, beast of prey
χρεών: necessity; it is necessary
ἀποβάλλω: to throw off
δικαστής: a judge
περιπέτεια: a turning right about
τέως: so long, meanwhile, the while
ἐπαύω: to shout over
ἀγέλη: a herd
πεντακισχίλιοι: five thousand
ἔμπας: alike
Αἰσονίδης: Aesonides
ἐκφεύγω: to flee out
καθίημι: to send down, let fall
πρόφρων: with forward mind
Κρόνος: Cronus
Ἰουδαῖος: a Jew
εἰκών: a likeness, image, portrait
ὑπήκοος: giving ear, listening to
Θεμιστοκλέης: Themistocles
ὀδούς: tooth
πίων: fat, plump
διακούω: to hear through, hear out
ἐκχωρέω: to go out and away, depart, emigrate
ποσός: of a certain quantity
τῇδε: here, thus
ποῖ: whither? (i.e., in what direction?)
Τίμαιος: Timaeus
ναύτης: a sailor, seaman; a fellow sailor
Πηλεύς: Peleus
φράτρα: a brotherhood
αὐτόθεν: from the very spot
Τυδεΐδης: son of Tydeus
πύθω: to make rot, to rot
Ἄρειος: devoted to Ares, warlike, martial; (πάγος:) the hill of Ares
πένθος: grief, sadness, sorrow
πεμπτός: sent
ποι: somewhither
ἀνδρεία: manliness, manhood, manly spirit
φέρτατος: bravest, best
ἠπειρώτης: of the mainland, living there
Μεγαλοπολίτης: citizen of Megalopolis
δάϊος: hostile, destructive
αἰδοῖος: regarded with reverence, august, venerable
ξανθός: yellow
Θέτις: Thetis
ἐξαίφνης: suddenly
προσχωρέω: to go to, approach
ἄχθομαι: to be loaded; to be annoyed
μάθημα: that which is learnt, a lesson
ἐπιεικής: fitting, meet, suitable
ὑπακούω: to listen, hearken, give ear
μίμησις: imitation
ναιετάω: to dwell
ἀλγέω: to feel bodily pain, suffer
ἀλάομαι: to wander, stray
δύστηνος: wretched, unhappy, unfortunate, disastrous
ἀπολογέομαι: to speak in defence, defend oneself
προφέρω: to bring before
στάδιος: standing firm
ἐμπειρία: experience
μεγαλήτωρ: great-hearted, heroic
προβάλλω: to throw before, throw
ἀναμιμνήσκω: to remind
εἰσβαίνω: to go into
φρουρά: a looking out, watch, guard
παρέξ: outside, before
ἑξακόσιοι: six hundred
μαρτυρέω: to be a witness, to bear witness, give evidence, bear testimony
κλῖμαξ: a ladder
παρασάγγης: a parasang
πόσος: how much? how many?
περιπλέω: to sail
ἀριστεύς: the best man
προσγίγνομαι: to come in addition, to accrue, to support
φθονέω: to bear ill-will
αἰνέω: (to tell;) to praise, approve, acquiesce in
ἁπλῶς: singly, in one way
ὀλιγαρχία: an oligarchy, government in the hands of a few families
ἀπωθέω: to thrust away, push back
οἰκοδομέω: to build a house
Πυθία: the Pythia, priestess of Pythian Apollo
μεταλαμβάνω: to have or get a share of
τέρας: a sign, wonder, marvel
δέκατος: tenth
τοξότης: a bowman, archer
ὑβρίζω: to wax wanton, run riot
βίαιος: forcible, violent
σέβομαι: to feel awe
ἀσκέω: to work curiously, form by art, fashion
ἑκάς: far, afar, far off
Ἀμβρακιώτης: inhabitant of Ambracia
διάληψις: grasping with both hands
πολεμίζω: to wage war, make war, fight
ἀδίκημα: a wrong done, a wrong