ἀγαθός : ᾰ̓γᾰθός
ἄγαλμα : ᾰ̓́γαλμα
ἄγαν : ᾰ̓́γᾱν
ἀγανακτέω : ᾰ̓γᾰνακτέω
ἀγάπη : ᾰ̓γᾰ́πη
ἀγγέλλω : ἀγγέλλω
ἄγγελος : ἄγγελος
ἀγνοέω : ἀγνοέω
ἀγορά : ᾰ̓γορά
ἀγορεύω : ἀγορεύω
ἄγω : ᾰ̓́γω
ἀγών : ᾰ̓γών
ἀγωνίζομαι : ᾰ̓γωνίζομαι
ἀδελφή : ᾰ̓δελφή
ἀδελφός : 1. ᾰ̓δελφός
ἀδικέω : ᾰ̓δῐκέω
ἀδίκημα : ἀδίκημα
ἄδικος : ᾰ̓́δῐκος
ἀδύνατος : ἀδύνατος
ἀεί : ἀεί
ἀείδω : ἀείδω
ἀέκων : ἀέκων
ἀθάνατος : ᾱ̓θᾰ́νᾰτος
ἄθλιος : ᾱ̓́θλιος
ἆθλον : ἆθλον
ἀθροίζω : ἀθροίζω
ἀθρόος : ἀθρόος
αἰδώς : αἰδώς
αἷμα : αἷμα
αἰνέω : αἰνέω
αἱρέω : αἱρέω
αἴρω : αἴρω
αἰσθάνομαι : αἰσθάνομαι
αἰσχρός : αἰσχρός
αἰσχύνω : αἰσχῡ́νω
αἰτέω : αἰτέω
αἰτία : αἰτία
αἰτιάομαι : αἰτιάομαι
αἴτιος : αἴτιος
αἴχμάλωτος : αἰχμάλωτος
ἀκολουθέω : ᾰ̓κολουθέω
ἀκούω : ἀκούω
ἀκριβής : ἀκρῑβής
ἄκρος : ἄκρος
ἄλγος : ἄλγος
ἀλήθεια : ᾰ̓λήθεια
ἀληθής : ᾰ̓ληθής
ἁλίσκομαι : ᾰ̔λίσκομαι
ἀλλά : ἀλλά
ἀλλήλων : ἀλλήλων
ἄλλος : ἄλλος
ἀλλότριος : ἀλλότριος
ἄλλως : ἄλλως
ἅμα : ἅμᾰ
ἁμαρτάνω : ᾰ̔μαρτᾰ́νω
ἀμείβω : ᾰ̓μείβω
ἀμείνων : ἀμείνων
ἀμελέω : ἀμελέω
ἀμύνω : ᾰ̓μῡ́νω
ἀμφί : ἀμφῐ́
ἀμφισβητέω : ἀμφισβητέω
ἀμφότερος : ἀμφότερος
ἄμφω : ἄμφω
ἄν : 3. ἄν
ἀνά : ἀνά
ἀνάγω : ἀνάγω
ἀναιρέω : ἀναιρέω
ἀναλαμβάνω : ἀναλαμβάνω
ἀναβαίνω : ἀναβαίνω
ἀναγιγνώσκω : ἀναγιγνώσκω
ἀνέχω : ἀνέχω
ἀνίστημι : ἀνίστημι
ἀνατίθημι : ἀνατίθημι
ἀναχωρέω : ἀναχωρέω
ἀναγκάζω : ᾰ̓ναγκάζω
ἀναγκαῖος : ᾰ̓ναγκαῖος
ἀνάγκη : ᾰ̓νάγκη
ἀνάθημα : ἀνάθημα
ἄναξ : ᾰ̓́ναξ
ἀνδρεῖος : ἀνδρεῖος
ἄνεμος : ᾰ̓́νεμος
ἄνευ : ᾰ̓́νευ
ἀνήρ : ἀνήρ
ἄνθος : 1. ἄνθος
ἄνθρωπος : ἄνθρωπος
ἀνοίγνυμι : ἀνοίγνῡμι
ἀντί : ἀντῐ́
ἄνω : ᾰ̓́νω
ἄξιος : ἄξιος
ἀξιόω : ἀξιόω
ἀπαλλάσσω : ἀπαλλάσσω
ἀπαντάω : ἀπαντάω
ἅπαξ : ᾰ̔́παξ
ἅπας : ᾰ̔́πας
ἄπειρος : 1. ἄπειρος
ἀπό : ᾰ̓πό
ἀπαγγέλλω : ἀπαγγέλλω
ἀπάγω : ἀπᾰ́γω
ἀφαιρέω : ἀφαιρέω
ἀποβαίνω : ἀποβαίνω
ἀποδείκνυμι : ἀποδείκνῡμι
ἀποδίδωμι : ἀποδίδωμι
ἄπειμι : 1. ἄπειμι
ἀπέρχομαι : ἀπέρχομαι
ἀπέχω : ἀπέχω
ἀποθνῄσκω : ἀποθνῄσκω
ἀφίημι : ἀφίημι
ἀφικνέομαι : ἀφικνέομαι
ἀφίστημι : ἀφίστημι
ἀποκρίνω : ἀποκρῑ́νω
ἀποκτείνω : ἀποκτείνω
ἀπολαμβάνω : ἀπολαμβάνω
ἀπολείπω : ἀπολείπω
ἀπόλλυμι : ἀπόλλῡμι
ἀπολογέομαι : ἀπολογέομαι
ἀπολύω : ἀπολύω
ἀποπέμπω : ἀποπέμπω
ἀποπλέω : ἀποπλέω
ἀποστέλλω : ἀποστέλλω
ἀποστερέω : ἀποστερέω
ἀποφαίνω : ἀποφαίνω
ἀπορία : ἀπορία
ἅπτω : ἅπτω
ἄρα : ἄρα
ἀργύριον : ἀργῠ́ριον
ἀρέσκω : ᾰ̓ρέσκω
ἀρετή : ᾰ̓ρετή
ἀριθμός : ᾰ̓ριθμός
ἄριστος : ᾰ̓́ριστος
ἀρκέω : ἀρκέω
ἅρμα : ἅρμα
ἀρμόζω : ἁρμόζω
ἀρόω : ᾰ̓ρόω
ἁρπάζω : ἁρπάζω
ἄρτι : ἄρτι
ἀρχαῖος : ἀρχαῖος
ἀρχή : ἀρχή
ἄρχω : ἄρχω
ἄρχων : ἄρχων
ἀσπίς : ἀσπίς
ἄστυ : ἄστυ
ἀσφάλεια : ἀσφᾰ́λεια
ἀσφαλής : ἀσφᾰλής
ἀτάρ : ᾰ̓τᾰ́ρ
ἅτε : 2. ᾰ̔́τε
ἄτη : ᾱ̓́τη
αὖ : αὖ
αὐξάνω : αὐξάνω
αὖτε : αὖτε
αὐτίκα : αὐτῐ́κᾰ
αὐτόθι : αὐτόθῐ
αὐτός : αὐτός
ἄφνω : ἄφνω
βαίνω : βαίνω
βάλλω : βάλλω
βάρβαρος : βάρβᾰρος
βαρύς : βᾰρύς
βασιλεία : βᾰσῐλεία
βασίλειος : βᾰσῐ́λειος
τὰ βασίλεια : βᾰσῐ́λειος
βασιλεύς : βᾰσῐλεύς
βασιλεύω : βᾰσῐλεύω
βασιλικός : βᾰσῐλικός
βέβαιος : βέβαιος
βέλος : βέλος
βέλτιστος : βέλτιστος
βελτίων : βελτῑ́ων
βία : βῐ́ᾱ
βιάζω : βιάζω
βίβλος : βίβλος
βίος : βίος
βιόω : βιόω
βλάπτω : βλάπτω
βλέπω : βλέπω
βοήθεια : βοήθεια
βοηθέω : βοηθέω
βουλεύω : βουλεύω
βουλή : βουλή
βούλομαι : βούλομαι
βοῦς : βοῦς
βραχύς : βρᾰχύς
βροτός : βροτός
βωμός : βωμός
γαῖα : γαῖα
γαμέω : γᾰμέω
γάμος : γᾰ́μος
γάρ : γάρ
γε : γε
γελάω : γελάω
γεννάω : γεννάω
γένος : γένος
γέρας : γέρᾰς
γέρων : 2. γέρων
γῆ : γῆ
γῆρας : γῆρας
γίγνομαι : γίγνομαι
γιγνώσκω : γιγνώσκω
γλυκύς : γλῠκύς
γλῶσσα : γλῶσσα
γνώμη : γνώμη
γοῦν : γοῦν
γράμμα : γράμμα
γράφω : γρᾰ́φω
γύμνος : γυμνός
γυνή : γῠνή
δαίμων : 1. δαίμων
δακρύω : δακρῡ́ω
δέ : δέ
δεῖ : δεῖ
δείδω : δείδω
δείκνυμι : δείκνῡμι
δειλός : δειλός
δεινός : δεινός
δεῖπνον : δεῖπνον
δέκα : δέκᾰ
δένδρον : δένδρον
δεξιός : δεξιός
δέος : δέος
δεσπότης : δεσπότης
δεῦρο : δεῦρο
δεύτερος : δεύτερος
δέχομαι : δέχομαι
δέω (1) : 1. δέω
δέω (2) : 2. δέω
δή : δή
δῆλος : δῆλος
δηλόω : δηλόω
δῆμος : δῆμος
δήπου : δή που
διά : διᾰ
διαιρέω : διαιρέω
διαβαίνω : διαβαίνω
διαβάλλω : διαβάλλω
διέρχομαι : διέρχομαι
διάκειμαι : διάκειμαι
διαλέγω : 2. διαλέγω
διαλύω : διαλύω
διάνοια : διάνοια
διοικέω : διοικέω
διαπράσσω : διαπράσσω
διατελέω : διατελέω
διατίθημι : διατίθημι
διατρίβω : διατρῑ́βω
διαφέρω : διαφέρω
διαφεύγω : διαφεύγω
διαφθείρω : διαφθείρω
διαθήκη : διαθήκη
δίαιτα : δίαιτα
διακόσιοι : διᾱκόσιοι
διδάσκω : δῐδάσκω
δίδωμι : δίδωμι
δικάζω : δῐκάζω
δίκαιος : δῐ́καιος
δικαιοσύνη : δῐκαιοσῠ́νη
δικαστήριον : δῐκαστήριον
δικαστής : δῐκαστής
δίκη : δῐ́κη
διό : διό
δῖος : δῖος
διότι : διότι
διπλοῦς : διπλόος
δισχίλιοι : δισχῑ́λιοι
δίχα : δίχᾰ
διώκω : δῐώκω
δόγμα : δόγμα
δοκεῖ : δοκέω
δοκέω : δοκέω
δόλος : δόλος
δόξα : δόξα
δόρυ : δόρυ
δοῦλος : δοῦλος
δράω : 1. δρᾱ́ω
δύναμαι : δῠ́νᾰμαι
δύναμις : δῠ́νᾰμις
δυνατός : δῠνᾰτός
δύο : δύο
δώδεκα : δώδεκα
δῶμα : δῶμα
δῶρον : δῶρον
ἐάν : ἐάν
ἔαρ : 1. ἔᾰρ
ἑαυτοῦ : ἑαυτοῦ
ἐάω : ἐάω
ἐγγύς : ἐγγῠ́ς
ἐγείρω : ἐγείρω
ἐγώ : ἐγώ
ἐθέλω : ἐθέλω
ἔθνος : ἔθνος
ἔθος : ἔθος
ἔθω : ἔθω
εἰ : εἰ
εἴδομαι : *εἴδω
εἶδος : εἶδος
εἰκός : εἰκός
εἴκοσι : εἰκόσι
εἰκών : εἰκών
εἰμί : εἰμί
εἶμι : εἶμι
εἶπον : εἶπον
εἴργω : εἴργω
εἰρήνη : εἰρήνη
εἰς : 1. εἰς
εἰσάγω : εἰσᾰ́γω
εἰσέρχομαι : εἰσέρχομαι
εἰσφέρω : εἰσφέρω
εἷς : εἷς
εἶτα : εἶτα
εἴτε : εἴτε
ἐκ : ἐκ
ἐξάγω : ἐξᾰ́γω
ἐξαιρέω : ἐξαιρέω
ἐξαπατάω : ἐξᾰπᾰτάω
ἐκβάλλω : ἐκβάλλω
ἐκδίδωμι : ἐκδῐ́δωμι
ἐξελέγχω : ἐξελέγχω
ἐξέρχομαι : ἐξέρχομαι
ἔξεστι : ἔξεστι
ἐκλείπω : ἐκλείπω
ἐκπέμπω : ἐκπέμπω
ἐκπίπτω : ἐκπίπτω
ἐκτείνω : ἐκτείνω
ἐκφέρω : ἐκφέρω
ἕκαστος : ἕκαστος
ἑκάτερος : ἑκᾰ́τερος
ἑκατόν : ἑκᾰτόν
ἐκεῖ : ἐκεῖ
ἐκεῖθεν : ἐκεῖθεν
ἐκεῖνος : ἐκεῖνος
ἐκκλησία : ἐκκλησία
ἐκτός : ἐκτός
ἑκών : ἑκών
ἐλάσσων : ἐλάσσων
ἐλαύνω : ἐλαύνω
ἔλεγος : ἔλεγος
ἐλέγχω : ἐλέγχω
ἐλευθερία : ἐλευθερία
ἐλεύθερος : ἐλεύθερος
ἐλευθερόω : ἐλευθερόω
ἐλπίζω : ἐλπίζω
ἐλπίς : ἐλπίς
ἐμαυτοῦ : ἐμαυτοῦ
ἐμός : ἐμός
ἐν : ἐν
ἐμβάλλω : ἐμβάλλω
ἐνδίδωμι : ἐνδίδωμι
ἐνθυμέομαι : ἐνθῡμέω
ἐγκαλέω : ἐγκᾰλέω
ἐμπίπτω : ἐμπίπτω
ἔμπροσθεν : ἔμπροσθε(ν)
ἐντυγχάνω : ἐντυγχάνω
ἐναντίος : ἐναντίος
ἕνεκα : ἕνεκα
ἔνθα : ἔνθᾰ
ἐνθάδε : ἐνθᾰ́δε
ἐνιαυτός : ἐνιαυτός
ἔνιοι : ἔνιος
ἐνίοτε : ἐνίοτε
ἐνταῦθα : ἐνταῦθα
ἐντεῦθεν : ἐντεῦθεν
ἐντός : ἐντός
ἕξ : ἕξ
ἐξετάζω : ἐξετάζω
ἐξαίφνης : ἐξαίφνης
ἑξήκοντα : ἑξήκοντα
ἐξουσία : ἐξουσία
ἔξω : ἔξω
ἕοικα : ἔοικα
ἐπεί : ἐπεί
ἐπείγω : ἐπείγω
ἐπειδάν : ἐπειδάν
ἔπειτα : ἔπειτα
ἐπί : ἐπί
ἐπαγγέλλω : ἐπαγγέλλω
ἐπάγω : ἐπᾰ́γω
ἐπαινέω : ἐπαινέω
ἐπανέρχομαι : ἐπανέρχομαι
ἐπιβάλλω : ἐπιβάλλω
ἐπιβουλεύω : ἐπιβουλεύω
ἐπιγίγνομαι : ἐπιγίγνομαι
ἐπιδείκνυμι : ἐπιδείκνῡμι
ἐπέρχομαι : ἐπέρχομαι
ἐπέχω : ἐπέχω
ἐπιθυμέω : ἐπιθῡμέω
ἐφίστημι : ἐφίστημι
ἐπιμέλεια : ἐπιμέλεια
ἐπιμελέομαι : ἐπιμελέομαι
ἐπιτίθημι : ἐπιτίθημι
ἐπιτρέπω : ἐπιτρέπω
ἐπιφανής : ἐπιφᾰνής
ἐπιφέρω : ἐπιφέρω
ἐπιχειρέω : ἐπιχειρέω
ἐπίσταμαι : 1. ἐπίστᾰμαι
ἐπιστήμη : ἐπιστήμη
ἐπιστολή : ἐπιστολή
ἐπιτήδειος : ἐπιτήδειος
ἕπομαι : ἕπομαι
ἔπος : ἔπος
ἐργάζομαι : ἐργάζομαι
ἔργον : ἔργον
ἐρῆμος : ἐρῆμος
ἔρις : ἔρῐς
ἔρομαι : ἔρομαι
ἔρχομαι : ἔρχομαι
ἐρῶ : ἐρῶ
ἔρως : ἔρως
ἐρωτάω : ἐρωτάω
ἐσθής : ἐσθής
ἐσθίω : ἐσθίω
ἑσπέρα : ἑσπέρα
ἔσχατος : ἔσχᾰτος
ἑταῖρος : ἑταῖρος
ἕτερος : ἕτερος
ἔτης : ἔτης
ἔτι : ἔτῐ
ἕτοιμος : ἑτοῖμος
ἔτος : ἔτος
εὖ : εὖ
εὐδαίμων : εὐδαίμων
εὐθύς : εὐθύς
εὔνοια : εὔνοια
εὑρίσκω : εὑρίσκω
εὐρύς : εὐρύς
εὔχομαι : εὔχομαι
ἐχθρός : ἐχθρός
ἔχω : 1. ἔχω
ἕως : 2. ἕως
ζάω : ζάω
Ζεύς : Ζεύς
ζητέω : ζητέω
ἤ : 1. ἤ
ἦ : 1. & 2. & 3. ἦ
ᾖ : ᾖ
ἡ : ἡ
ἥ : ἥ
ᾗ : 1. ᾗ
ἡγεμών : ἡγεμών
ἡγέομαι : ἡγέομαι
ἥδη : ἤδη
ἥδομαι : ἥδομαι
ἡδονή : ἡδονή
ἡδύς : ἡδύς
ἥκιστος : ἥκιστος
ἥκω : ἥκω
ἡλικία : ἡλῐκία
ἥλιος : ἥλιος
ἧμαι : ἧμαι
ἡμέρα : ἡμέρα
ἡμέτερος : ἡμέτερος
ἠμί : ἠμί
ἥμισυς : ἥμῐσυς
ἤπειρος : ἤπειρος
ἥρως : ἥρως
ἡσυχία : ἡσῠχία
ἡσσάομαι : ἡσσάω
ἥσσων : ἥσσων
θάλασσα : θᾰ́λασσα
θάνατος : θᾰ́νᾰτος
θάπτω : θάπτω
θαρσέω : θαρσέω
θαυμάζω : θαυμάζω
θαυμαστός : θαυμαστός
θεά : θεά
θεάομαι : θεάομαι
θεῖος : 1. θεῖος
θεός : θεός
θεραπεύω : θερᾰπεύω
θέρμος : θερμός  # but this is adjective, not noun
θέω : 1. θέω
θεωρέω : θεωρέω
θνήσκω : θνῄσκω
θρόνος : θρόνος
θυγάτηρ : θῠγᾰ́τηρ
θυμός : θῡμός
θύρα : θῠ́ρα
θυσία : θῠσία
θύω : 1. θύω
θώραξ : θώραξ
ἰατρός : ῑ̓ᾱτρός
ἴδιος : ῐ̓́δῐος
ἰδιώτης : ῐ̓δῐώτης
ἰδοῦ : ἰδοῦ & ἰδού
ἱδρύω : ἱδρῡ́̆ω
ἱερεύς : ἱερεύς
ἱερόν : ἱερόν
ἱερός : ἱερός
ἵημι : ἵημι
ἱκανός : ῐ̔κᾰνός
ἱκνέομαι : ῑ̔κνέομαι
ἵνα : ῐ̔́νᾰ
ἱππεύς : ἱππεύς
ἵππος : ἵππος
ἴσος : ἴσος
ἵστημι : ἵστημι
ἱστορία : ἱστορία
ἰσχυρός : ἰσχῡρός
ἰσχύς : ἰσχῡ́ς
καθά : κᾰθά
καθαρός : κᾰθᾰρός
καθό : καθό
καί : καί
καίπερ : καίπερ
καιρός : καιρός
καίτοι : καίτοι
κακός : κᾰκός
καλέω : καλέω
κάλλος : κάλλος
καλός : κᾰλός
κάμνω : κάμνω
κἀν : κἀν
κἄν : κἄν
καρδία : καρδία
καρπός : 1. καρπός
κατά : 1. κᾰτᾰ́
καταβαίνω : καταβαίνω
καταγιγνώσκω : καταγιγνώσκω
κατάγω : κατᾰ́γω
κάθημαι : κάθημαι
καθίστημι : κᾰθίστημι
καταλαμβάνω : καταλαμβάνω
καταλείπω : καταλείπω
καταλύω : καταλύω
καταπλήσσω : καταπλήσσω
κατασκευάζω : κατασκευάζω
καταστρέφω : καταστρέφω
καταφεύγω : καταφεύγω
καταφρονέω : καταφρονέω
κατέχω : κατέχω
κατηγορέω : κατηγορέω
κατοικέω : κατοικέω
κεῖμαι : κεῖμαι
κελεύω : κελεύω
κενός : κενός
κέρας : κέρας
κεφαλή : κεφᾰλή
κῆρυξ : κῆρυξ
κινδυνεύω : κινδυνεύω
κίνδυνος : κίνδῡνος
κινέω : κινέω
κλέος : κλέος
κλέπτω : κλέπτω
κλίνω : κλίνω
κοινός : κοινός
κολάζω : κολάζω
κόλπος : κόλπος
κομίζω : κομίζω
κόπτω : κόπτω
κόρη : κόρη
κοσμέω : κοσμέω
κόσμος : κόσμος
κρατέω : κρᾰτέω
κράτιστος : κράτιστος
κράτος : κρᾰ́τος
κρείσσων : κρείσσων
κρίνω : κρίνω
κρίσις : κρῐ́σις
κριτής : κρῐτής
κρύπτω : κρύπτω
κτάομαι : κτάομαι
κτείνω : κτείνω
κύκλος : κύκλος
κυρέω : κῠρέω
κύριος : κῡ́ριος
κύων : κῠ́ων
κωλύω : κωλύω
κώμη : κώμη
λαγχάνω : λαγχάνω
λαλέω : λᾰλέω
λαμβάνω : λαμβάνω
λαμπρός : λαμπρός
λανθάνω : λανθάνω
λέγω : λέγω
λείπω : λείπω
λευκός : λευκός
λεώς : λᾱός
λίθος : λῐ́θος
λιμήν : λῐμήν
λίμνη : λίμνη
λιμός : λῑμός
λογίζομαι : λογίζομαι
λόγος : λόγος
λοιπός : λοιπός
λόφος : λόφος
λυπέω : λῡπέω
λύω : λύω
μακρός : μακρός
μάλα : μᾰ́λᾰ
μάλιστα : μάλιστα
μᾶλλον : μᾶλλον
μανθάνω : μανθάνω
μανία : μᾰνία
μάντις : μάντις
μαρτυρέω : μαρτυρέω
μαρτυρία : μαρτῠρία
μάρτυς : μάρτῠς
μάχη : μᾰ́χη
μάχομαι : μᾰ́χομαι
μέγαρον : μέγᾰρον
μέγας : μέγᾰς μεγάλη μέγα
μέγεθος : μέγεθος
μέλας : μέλᾱς μέλαινα μέλᾰν
μέλει : μέλει
μέλλω : μέλλω
μέν : μέν
μέντοι : μέντοι
μένω : μένω
μέρος : μέρος
μέσος : μέσος
μετά : μετά
μεταβάλλω : μεταβάλλω
μεταπέμπω : μεταπέμπω
μετέχω : μετέχω
μεταξύ : μεταξύ
μέχρι : μέχρῐ
μή : μή
μηδέ : μηδέ
μηδείς : μηδείς
μήτε : μήτε
μῆκος : μῆκος
μήν : 1. μήν
μήτηρ : μήτηρ
μηχανή : μηχᾰνή
μικρός : μῑκρός
μιμνήσκω : μιμνήσκω
μισέω : μῑσέω
μισθός : μισθός
μνᾶ : μνᾶ
μνήμη : μνήμη
μοῖρα : μοῖρα
μόνος : μόνος
μῦθος : μῦθος
μυριάς : μῡριάς
μυρίος : μῡρῐ́ος
ναί : ναί
ναυμαχία : ναυμᾰχία
ναῦς : ναῦς
ναυτικός : ναυτικός
νεανίας : νεᾱνίας
νεκρός : 2. νεκρός  # 1 is the adjective 'dead'
νέμω : νέμω
νέος : νέος
νεώς : 1. νεώς  # or favour νᾱός? (2 is the genitive of ναῦς)
νῆσος : νῆσος
νικάω : νῑκάω
νίκη : 2. νῑ́κη
νοέω : νοέω
νομίζω : νομίζω
νόμιμος : νόμιμος
νόμος : νόμος
νοῦς : νοῦς
νόσος : νόσος
νύμφη : νύμφη
νῦν : νῦν
νύξ : νύξ
ξένος : ξένος
ξύλον : ξύλον
ὁ : ὁ ἡ τό
ὅδε : ὅδε ἥδε τόδε
ὁδός : ὁδός
ὅθεν : ὅθεν
οἶδα : οἶδα
οἰκεῖος : οἰκεῖος
οἰκέτης : οἰκέτης
οἰκέω : οἰκέω
οἰκία : οἰκία
οἰκοδομέω : οἰκοδομέω
οἶκος : οἶκος
οἶμαι : οἶμαι
οἷος : οἷος
οἷος τ’ εἰμί : οἷος
οἴχομαι : οἴχομαι
ὀκτώ : ὀκτώ
ὀλίγος : ὀλίγος
ὄλλυμι : ὄλλῡμι
ὅλος : ὅλος
ὄμνυμι : ὄμνῡμι
ὅμοιος : ὅμοιος
ὁμοιόω : ὁμοιόω
ὁμολογέω : ὁμολογέω
ὁμόω : ὁμόομαι
ὅμως : ὅμως
ὄνομα : ὄνομα
ὀνομάζω : ὀνομάζω
ὀξύς : 1. ὀξύς
ὁπλίτης : ὁπλῑ́της
ὅπλον : ὅπλον
ὁποῖος : ὁποῖος
ὁπόσος : ὁπόσος
ὁπότε : ὁπότε
ὅπου : ὅπου
ὅπως : ὅπως
ὁράω : ὁράω
ὀργή : 1. ὀργή
ὀργίζω : ὀργίζω
ὀρθός : ὀρθός
ὀρθόω : ὀρθόω
ὅρκος : ὅρκος
ὁρμάω : ὁρμάω
ὁρμή : ὁρμή
ὄρος : ὄρος
ὅρος : ὅρος
ὅς : 1. ὅς
ὅσος : ὅσος
ὅσπερ : ὅσπερ
ὅστε : ὅστε
ὅστις : ὅστις
ὅταν : ὅταν
ὅτε : 1. ὅτε
ὅτι : ὅτῐ
οὐ : οὐ
οὐδέ : οὐδέ
οὐδείς : οὐδείς
οὐκέτι : οὐκέτῐ
οὔτε : οὔτε
οὔτις : οὔτις
οὔπω : οὔπω
οὗ : 1. οὗ  # ?
οὐκοῦν : οὐκοῦν
οὖν : οὖν
οὐρανός : οὐρᾰνός
οὐσία : οὐσία
οὗτος : οὗτος
οὕτως : οὕτως
ὀφείλω : ὀφείλω
ὀφθαλμός : ὀφθαλμός
ὄφρα : ὄφρᾰ
ὄχλος : ὄχλος
ὄψις : ὄψις
πάθος : πᾰ́θος
παιδεύω : παιδεύω
παῖς : παῖς
παλαιός : πᾰλαιός
πάλιν : πᾰ́λῐν
παντάπασι : παντᾰ́πᾱσι(ν)
πάντῃ : πάντῃ
πάνυ : πᾰ́νῠ
παρά : πᾰρᾰ́
παραγγέλλω : παραγγέλλω
παραγίγνομαι : παραγίγνομαι
παραδίδωμι : παραδίδωμι
παράδοξος : παράδοξος
πάρειμι : 1. πάρειμι
πάρεστι : πάρεστι
παρέρχομαι : παρέρχομαι
παρέχω : παρέχω
παρίστημι : παρίστημι
παρακαλέω : παρακαλέω
παραλαμβάνω : παραλαμβάνω
παραπλήσιος : παραπλήσιος
παρασκευάζω : παρασκευάζω
παρασκευή : παρασκευή
παραχρῆμα : παραχρῆμα
παρθένος : παρθένος
πᾶς : 1. πᾶς
πάσσω : πάσσω
πάσχω : πάσχω
πατήρ : πᾰτήρ
πάτριος : πάτριος
πατρίς : πατρίς
παύω : παύω
πεδίον : πεδίον
πεζός : πεζός
πείθω : πείθω
πειράζω : πειράζω
πειράω : πειράω
πέλας : πέλᾰς
πέμπω : πέμπω
πεντακόσιοι : πεντᾰκόσιοι
πέντε : πέντε
πεντήκοντα : πεντήκοντα
πέρ : περ
περάω : περάω
πέρθω : πέρθω
περί : περί
περίειμι : 1. περίειμι
περιίστημι : περιίστημι
πέτρα : πέτρᾱ
πηρός : πηρός
πίμπλημι : πίμπλημι
πίνω : πῑ́νω
πίπτω : πίπτω
πιστεύω : πιστεύω
πίστις : πίστις
πιστός : 1. πιστός
πλεῖστος : πλεῖστος
πλείων : πλείων
πλέω : 1. πλέω
πλέως : πλέως
πλῆθος : πλῆθος
πλήν : πλήν
πληρόω : πληρόω
πλησίος : πλησίος
πλήσσω : πλήσσω
πλοῖον : πλοῖον
πλούσιος : πλούσιος
πλοῦτος : 1. πλοῦτος
πνεῦμα : πνεῦμα
ποιέω : ποιέω
ποιητής : ποιητής
ποῖος : ποῖος
πολεμέω : πολεμέω
πολέμιος : πολέμιος
οἱ πολέμιοι : πολέμιος
πόλεμος : πόλεμος
πολιορκέω : πολιορκέω
πολιορκία : πολιορκία
πόλις : πόλις
πολιτεία : πολῑτεία
πολιτεύω : πολιτεύω
πολίτης : πολίτης
πολιτικός : πολῑτῐκός
πολλάκις : πολλᾰ́κῐς
πολύς : πολύς
πονηρός : πονηρός
πόνος : πόνος
πορεία : πορεία
πορεύω : πορεύω
πορθέω : πορθέω
πόρρω : πρόσω
ποταμός : ποτᾰμός
ποτέ : ποτε
πότερος : πότερος
ποτός : ποτός
πού : που
πούς : πούς
πρᾶγμα : πρᾶγμα
πρᾶξις : πρᾶξις
πράσσω : πρᾱ́σσω
πρεσβευτής : πρεσβευτής
πρεσβεύω : πρεσβεύω
πρέσβυς : πρέσβυς
πρίν : πρίν
πρό : πρό
προάγω : προᾰ́γω
προαίρεσις : προαίρεσις
προαιρέω : προαιρέω
πρόγονος : πρόγονος
προδίδωμι : προδίδωμι
προερέω : *προείρω
προέρχομαι : προέρχομαι
προθέω : προθέω
προθυμία : προθῡμία
πρόθυμος : πρόθῡμος
προίημι : προΐημι
προίστημι : προΐστημι
πρόνοια : πρόνοια
πρός : πρός
προσαγορεύω : προσαγορεύω
προσάγω : προσᾰ́γω
προσδέχομαι : προσδέχομαι
πρόσειμι : 1. πρόσειμι
προσέρχομαι : προσέρχομαι
προσέχω : προσέχω
προσήκω : προσήκω
πρόσθεν : πρόσθε(ν)
προσλαμβάνω : προσλαμβάνω
προσπίπτω : προσπίπτω
προστάσσω : προστάσσω
προστίθημι : προστίθημι
προσφέρω : προσφέρω
πρόσωπον : πρόσωπον
πρότερος : πρότερος
πρόφασις : πρόφᾰσις
προφήτης : προφήτης
πρῶτος : πρῶτος
πτερόν : πτερόν
πύλη : πύλη
πυνθάνομαι : πυνθάνομαι
πῦρ : πῦρ
πωλέω : πωλέω
πώποτε : πώποτε
πως : πως
πῶς : πῶς
ῥᾴδιος : ῥᾴδιος
ῥέω : ῥέω
ῥήτωρ : ῥήτωρ
ῥύθμος : ῥυθμός
ῥώμη : ῥώμη
σαυτοῦ : σαυτοῦ
σαφής : σᾰφής
σελήνη : σελήνη
σημαίνω : σημαίνω
σημεῖον : σημεῖον
σῖτος : σῖτος
σκέπτομαι : σκέπτομαι
σκευάζω : σκευάζω
σκήνη : σκηνή
σκοπέω : σκοπέω
σός : σός
σοφία : σοφία
σοφός : σοφός
σπεύδω : σπεύδω
σπονδή : σπονδή
σπουδάζω : σπουδάζω
σπουδή : σπουδή
στάδιον : στᾰ́διον
στάσις : στᾰ́σις
στέλλω : στέλλω
στερέω : στερέω
στέρνον : στέρνον
στεφανόω : στεφᾰνόω
στόλος : στόλος
στόμα : στόμα
στρατεία : στρᾰτεία
στράτευμα : στρᾰ́τευμα
στρατεύω : στρᾰτεύω
στρατηγός : στρᾰτηγός
στρατιά : στρᾰτιά
στρατιώτης : στρατιώτης
στρατοπεδεύω : στρᾰτοπεδεύω
στρατόπεδον : στρᾰτόπεδον
στρατός : στρᾰτός
στρέφω : στρέφω
σύ : σῠ́
σύν : σῠ́ν
συνάγω : συνᾰ́γω
συνάπτω : συνάπτω
συγγενής : συγγενής
συγγνώμη : συγγνώμη
σύγκλητος : σύγκλητος
συλλαμβάνω : συλλαμβάνω
συμβαίνω : συμβαίνω
συμβάλλω : συμβάλλω
συμβουλεύω : συμβουλεύω
σύνειμι : 1. σύνειμι
συνέρχομαι : συνέρχομαι
συνεχής : σῠνεχής
συνθήκη : συνθήκη
συνίστημι : συνίστημι
συμμαχέω : συμμᾰχέω
συμμαχία : συμμᾰχία
σύμμαχος : σύμμᾰχος
σύμπας : σύμπας σύμπᾱσα σύμπᾰν
συμφέρω : συμφέρω
συμφορά : συμφορά
συντάσσω : συντάσσω
συντίθημι : συντίθημι
συγχωρέω : συγχωρέω
σφάζω : σφάζω
σφεῖς : σφεῖς
σφέτερος : σφέτερος
σφόδρα : σφόδρα
σχεδόν : σχεδόν
σχῆμα : σχῆμα
σχολή : σχολή
σώζω : σῴζω
σῶμα : σῶμα
σωτηρία : σωτηρία
τάλαντον : τᾰ́λαντον
τάξις : τάξις
τάσσω : τάσσω
ταύτῃ : οὗτος
ταῦρος : ταῦρος
ταὐτό : ταὐτό
τάφος : 1. τᾰ́φος
τάχος : τᾰ́χος
ταχύς : τᾰχῠ́ς
τε : τε
τείνω : τείνω
τειχέω : τειχέω
τεῖχος : τεῖχος
τεκμήριον : τεκμήριον
τέκνον : τέκνον
τελευταῖος : τελευταῖος
τελευτάω : τελευτάω
τελευτή : τελευτή
τελέω : τελέω
τέλος : τέλος
τέμνω : τέμνω
τεσσαράκοντα : τεσσᾰρᾰ́κοντα
τέσσαρες : τέσσᾰρες
τέταρτος : τέτᾰρτος
τετρακόσιοι : τετρᾰκόσιοι
τεύχω : τεύχω
τέχνη : τέχνη
τῇ : τῇ
τηλικοῦτος : τηλῐκοῦτος
τηρέω : τηρέω
τίθημι : τῐ́θημι
τίκτω : τίκτω
τιμάω : τῑμάω
τιμή : τῑμή
τιμωρέω : τῑμωρέω
τιμωρία : τῑμωρία
τις : τῐς
τίς : τῐ́ς
τοι : 2. τοι
τοίνυν : τοίνῠν
τοιόσδε : τοιόσδε
τοιοῦτος : τοιοῦτος
τολμάω : τολμάω
τόξον : τόξον
τόπος : τόπος
τοσόσδε : τοσόσδε
τοσοῦτος : τοσοῦτος
τότε : τότε
τραῦμα : τραῦμα
τρεῖς : τρεῖς
τρέπω : τρέπω
τρέφω : τρέφω
τρέχω : τρέχω
τρέω : τρέω
τριάκοντα : τρῐᾱ́κοντα
τριακόσιοι : τρῐᾱκόσιοι
τρίβω : τρῑ́βω
τριήρης : τρῐήρης
τρίτος : τρῐ́τος
τρόπος : τρόπος
τροφή : τροφή
τυγχάνω : τυγχάνω
τυραννίς : τῠραννίς
τύραννος : 1. τῠ́ραννος
τύχη : τῠ́χη
ὑβρίζω : ὑβρίζω
ὕβρις : ὕβρις
ὑγιής : ῠ̔γιής
ὕδωρ : ὕδωρ
υἱός : υἱός
ὑμέτερος : ῡ̔μέτερος
ὕπατος : ὕπᾰτος
ὑπέρ : ὑπέρ
ὑπερβάλλω : ὑπερβάλλω
ὑπερβολή : ὑπερβολή
ὑπισχνέομαι : ὑπισχνέομαι
ὕπνος : ὕπνος
ὑπό : ὑπό
ὑπακούω : ὑπᾰκούω
ὑπάρχω : ὑπάρχω
ὑπολαμβάνω : ὑπολαμβάνω
ὑπομένω : ὑπομένω
ὕστερος : ὕστερος
ὑψηλός : ὑψηλός
φαίνω : φαίνω
φάλαγξ : φᾰ́λαγξ
φανερός : φᾰνερός
φάρμακον : φάρμᾰκον
φάσκω : φάσκω
φαῦλος : φαῦλος
φέρω : φέρω
φεύγω : φεύγω
φημί : φημί
φθάνω : φθᾱ́νω
φθείρω : φθείρω
φιλέω : φῐλέω
φιλία : φῐλία
φίλιος : φῐ́λιος
φίλος : φῐ́λος
φοβέω : φοβέω
φόβος : φόβος
φόνος : φόνος
φράζω : φράζω
φρήν : φρήν
φρονέω : φρονέω
φροντίζω : φροντίζω
φρουρά : φρουρά
φυγάς : φῠγᾰ́ς
φυγή : φῠγή
φυλακή : φῠλᾰκή
φυλάσσω : φῠλάσσω
φυλή : φῡλή
φύσις : φῠ́σις
φύω : φῠ́ω
φωνέω : φωνέω
φωνή : φωνή
φῶς : φῶς  # possibly φᾰ́ος preferred
χαίρω : χαίρω
χαλεπός : χᾰλεπός
χάρις : χᾰ́ρις
χειμών : χειμών
χείρ : χείρ
χειρόω : χειρόω
χείρων : χείρων
χέω : 1. χέω
χίλιοι : χῑ́λιοι
χόω : χόω
χράομαι : χράομαι
χράω : 3. χράω
χρεία : χρεία
χρή : χρή
χρῆμα : 1. χρῆμα
τὰ χρήματα : 1. χρῆμα
χρήσιμος : χρήσῐμος
χρηστός : χρηστός
χρόνος : χρόνος
χρυσοῦς : χρυσοῦς
χρυσός : χρῡσός
χώρα : χώρα
χωρέω : χωρέω
χωρίον : χωρίον
χωρίς : χωρίς
ψευδής : ψευδής
ψεύδω : ψεύδω
ψηφίζω : ψηφίζω
ψήφισμα : ψήφισμα
ψῆφος : ψῆφος
ψυχή : ψῡχή
ὦ : 1. ὦ
ὧδε : ὧδε
ὥρα : ὥρᾱ
ὡς : ὡς
ὥσπερ : ὥσπερ
ὥστε : ὥστε
ὠφελέω : ὠφελέω
