ἀγαθός : ἀγαθός
ἄγαλμα : -
ἄγαν : -
ἀγανακτέω : ἀγανακτέω
ἀγάπη : ἀγάπη
ἀγγέλλω : ἀγγέλλω
ἄγγελος : ἄγγελος
ἀγνοέω : ἀγνοέω
ἀγορά : ἀγορά
ἀγορεύω : -
ἄγω : ἄγω
ἀγών : ἀγών
ἀγωνίζομαι : ἀγωνίζομαι
ἀδελφή : ἀδελφή
ἀδελφός : ἀδελφός
ἀδικέω : ἀδικέω
ἀδίκημα : ἀδίκημα
ἄδικος : ἄδικος
ἀδύνατος : ἀδύνατος
ἀεί : ἀεί
ἀείδω : ᾄδω  # the Attic form
ἀέκων : ἄκων  # the Attic form
ἀθάνατος : -
ἄθλιος : -
ἆθλον : -
ἀθροίζω : ἀθροίζω
ἀθρόος : -
αἰδώς : αἰδώς
αἷμα : αἷμα
αἰνέω : αἰνέω
αἱρέω : αἱρέομαι
αἴρω : αἴρω
αἰσθάνομαι : αἰσθάνομαι
αἰσχρός : αἰσχρός
αἰσχύνω : αἰσχύνομαι
αἰτέω : αἰτέω
αἰτία : αἰτία
αἰτιάομαι : -
αἴτιος : αἴτιος
αἴχμάλωτος : αἰχμάλωτος  # @@@ accent problem upstream
ἀκολουθέω : ἀκολουθέω
ἀκούω : ἀκούω
ἀκριβής : ἀκριβής
ἄκρος : ἄκρον  # adj vs noun
ἄλγος : -
ἀλήθεια : ἀλήθεια
ἀληθής : ἀληθής
ἁλίσκομαι : -
ἀλλά : ἀλλά
ἀλλήλων : ἀλλήλων
ἄλλος : ἄλλος
ἀλλότριος : ἀλλότριος
ἄλλως : ἄλλως
ἅμα : ἅμα
ἁμαρτάνω : ἁμαρτάνω
ἀμείβω : -  # although has the noun ἀμοιβή
ἀμείνων : -
ἀμελέω : ἀμελέω
ἀμύνω : ἀμύνομαι
ἀμφί : -
ἀμφισβητέω : -
ἀμφότερος : ἀμφότεροι
ἄμφω : -
ἄν : ἄν
ἀνά : ἀνά
ἀνάγω : ἀνάγω
ἀναιρέω : ἀναιρέω
ἀναλαμβάνω : ἀναλαμβάνω
ἀναβαίνω : ἀναβαίνω
ἀναγιγνώσκω : ἀναγινώσκω
ἀνέχω : ἀνέχομαι
ἀνίστημι : ἀνίστημι
ἀνατίθημι : ἀνατίθεμαι
ἀναχωρέω : ἀναχωρέω
ἀναγκάζω : ἀναγκάζω
ἀναγκαῖος : ἀναγκαῖος
ἀνάγκη : ἀνάγκη
ἀνάθημα : ἀνάθεμα
ἄναξ : -
ἀνδρεῖος : -
ἄνεμος : ἄνεμος
ἄνευ : ἄνευ
ἀνήρ : ἀνήρ
ἄνθος : ἄνθος
ἄνθρωπος : ἄνθρωπος
ἀνοίγνυμι : ἀνοίγω
ἀντί : ἀντί
ἄνω : ἄνω
ἄξιος : ἄξιος
ἀξιόω : ἀξιόω
ἀπαλλάσσω : ἀπαλλάσσω
ἀπαντάω : ἀπαντάω
ἅπαξ : ἅπαξ
ἅπας : ἅπας
ἄπειρος : ἄπειρος
ἀπό : ἀπό
ἀπαγγέλλω : ἀπαγγέλλω
ἀπάγω : ἀπάγω
ἀφαιρέω : ἀφαιρέω
ἀποβαίνω : ἀποβαίνω
ἀποδείκνυμι : ἀποδείκνυμι
ἀποδίδωμι : ἀποδίδωμι
ἄπειμι : ἄπειμι
ἀπέρχομαι : ἀπέρχομαι
ἀπέχω : ἀπέχω
ἀποθνῄσκω : ἀποθνῄσκω
ἀφίημι : ἀφίημι
ἀφικνέομαι : ἀφικνέομαι
ἀφίστημι : ἀφίσταμαι
ἀποκρίνω : ἀποκρίνομαι
ἀποκτείνω : ἀποκτείνω
ἀπολαμβάνω : ἀπολαμβάνω
ἀπολείπω : ἀπολείπω
ἀπόλλυμι : ἀπόλλυμι
ἀπολογέομαι : ἀπολογέομαι
ἀπολύω : ἀπολύω
ἀποπέμπω : -
ἀποπλέω : ἀποπλέω
ἀποστέλλω : ἀποστέλλω
ἀποστερέω : ἀποστερέω
ἀποφαίνω : -
ἀπορία : ἀπορία
ἅπτω : ἅπτω
ἄρα : ἄρα
ἀργύριον : ἀργύριον
ἀρέσκω : ἀρέσκω
ἀρετή : ἀρετή
ἀριθμός : ἀριθμός
ἄριστος : -
ἀρκέω : ἀρκέω
ἅρμα : ἅρμα
ἀρμόζω : ἁρμόζομαι
ἀρόω : -  # there's ἀροτριάω and ἄροτρον
ἁρπάζω : ἁρπάζω
ἄρτι : ἄρτι
ἀρχαῖος : ἀρχαῖος
ἀρχή : ἀρχή
ἄρχω : ἄρχω
ἄρχων : ἄρχων
ἀσπίς : ἀσπίς
ἄστυ : -
ἀσφάλεια : ἀσφάλεια
ἀσφαλής : ἀσφαλής
ἀτάρ : -
ἅτε : -
ἄτη : -
αὖ : -
αὐξάνω : αὐξάνω
αὖτε : -
αὐτίκα : -
αὐτόθι : -
αὐτός : αὐτός
ἄφνω : ἄφνω
βαίνω : -
βάλλω : βάλλω
βάρβαρος : βάρβαρος
βαρύς : βαρύς
βασιλεία : βασιλεία
βασίλειος : βασίλειος
τὰ βασίλεια : -
βασιλεύς : βασιλεύς
βασιλεύω : βασιλεύω
βασιλικός : βασιλικός
βέβαιος : βέβαιος
βέλος : βέλος
βέλτιστος : βέλτιον  # ???
βελτίων : βέλτιον
βία : βία
βιάζω : βιάζω
βίβλος : βίβλος
βίος : βίος
βιόω : βιόω
βλάπτω : βλάπτω
βλέπω : βλέπω
βοήθεια : βοήθεια
βοηθέω : βοηθέω
βουλεύω : βουλεύομαι
βουλή : βουλή
βούλομαι : βούλομαι
βοῦς : βοῦς
βραχύς : βραχύς
βροτός : -
βωμός : βωμός
γαῖα : γῆ  # ?
γαμέω : γαμέω
γάμος : γάμος
γάρ : γάρ
γε : γέ
γελάω : γελάω
γεννάω : γεννάω
γένος : γένος
γέρας : -
γέρων : γέρων
γῆ : γῆ
γῆρας : γῆρας
γίγνομαι : γίνομαι
γιγνώσκω : γινώσκω
γλυκύς : γλυκύς
γλῶσσα : γλῶσσα
γνώμη : γνώμη
γοῦν : -
γράμμα : γράμμα
γράφω : γράφω
γύμνος : γυμνός
γυνή : γυνή
δαίμων : δαίμων
δακρύω : δακρύω
δέ : δέ
δεῖ : δεῖ
δείδω : -
δείκνυμι : δείκνυμι
δειλός : δειλός
δεινός : -  # there's δεινῶς
δεῖπνον : δεῖπνον
δέκα : δέκα
δένδρον : δένδρον
δεξιός : δεξιός
δέος : δέος
δεσπότης : δεσπότης
δεῦρο : δεῦρο
δεύτερος : δεύτερος
δέχομαι : δέχομαι
δέω : δέω
δέω : δέω
δή : δή
δῆλος : δῆλος
δηλόω : δηλόω
δῆμος : δῆμος
δήπου : δήπου
διά : διά
διαιρέω : διαιρέω
διαβαίνω : διαβαίνω
διαβάλλω : διαβάλλω
διέρχομαι : διέρχομαι
διάκειμαι : -
διαλέγω : διαλέγομαι
διαλύω : διαλύω
διάνοια : διάνοια
διοικέω : -
διαπράσσω : -
διατελέω : διατελέω
διατίθημι : διατίθεμαι
διατρίβω : διατρίβω
διαφέρω : διαφέρω
διαφεύγω : διαφεύγω
διαφθείρω : διαφθείρω
διαθήκη : διαθήκη
δίαιτα : -
διακόσιοι : διακόσιοι
διδάσκω : διδάσκω
δίδωμι : δίδωμι
δικάζω : -  # there's καταδικάζω
δίκαιος : δίκαιος
δικαιοσύνη : δικαιοσύνη
δικαστήριον : -
δικαστής : δικαστής
δίκη : δίκη
διό : διό
δῖος : -
διότι : διότι
διπλοῦς : διπλοῦς
δισχίλιοι : δισχίλιοι
δίχα : -
διώκω : διώκω
δόγμα : δόγμα
δοκεῖ : δοκέω  # also has δοκέω
δοκέω : δοκέω
δόλος : δόλος
δόξα : δόξα
δόρυ : -
δοῦλος : δοῦλος
δράω : -
δύναμαι : δύναμαι
δύναμις : δύναμις
δυνατός : δυνατός
δύο : δύο
δώδεκα : δώδεκα
δῶμα : δῶμα
δῶρον : δῶρον
ἐάν : ἐάν
ἔαρ : -
ἑαυτοῦ : ἑαυτοῦ
ἐάω : ἐάω
ἐγγύς : ἐγγύς
ἐγείρω : ἐγείρω
ἐγώ : ἐγώ
ἐθέλω : θέλω
ἔθνος : ἔθνος
ἔθος : ἔθος
ἔθω : ἐθίζω
εἰ : εἰ
εἴδομαι : ὁράω
εἶδος : εἶδος
εἰκός : -
εἴκοσι : εἴκοσι(ν)
εἰκών : εἰκών
εἰμί : εἰμί
εἶμι : -
εἶπον : λέγω
εἴργω : -
εἰρήνη : εἰρήνη
εἰς : εἰς
εἰσάγω : εἰσάγω
εἰσέρχομαι : εἰσέρχομαι
εἰσφέρω : εἰσφέρω
εἷς : εἷς
εἶτα : εἶτα
εἴτε : εἴτε
ἐκ : ἐκ
ἐξάγω : ἐξάγω
ἐξαιρέω : ἐξαιρέω
ἐξαπατάω : ἐξαπατάω
ἐκβάλλω : ἐκβάλλω
ἐκδίδωμι : ἐκδίδωμι
ἐξελέγχω : -  # there's διακατελέγχομαι
ἐξέρχομαι : ἐξέρχομαι
ἔξεστι : ἔξεστι(ν)
ἐκλείπω : ἐκλείπω
ἐκπέμπω : ἐκπέμπω
ἐκπίπτω : ἐκπίπτω
ἐκτείνω : ἐκτείνω
ἐκφέρω : ἐκφέρω
ἕκαστος : ἕκαστος
ἑκάτερος : -
ἑκατόν : ἑκατόν
ἐκεῖ : ἐκεῖ
ἐκεῖθεν : ἐκεῖθεν
ἐκεῖνος : ἐκεῖνος
ἐκκλησία : ἐκκλησία
ἐκτός : ἐκτός
ἑκών : ἑκών
ἐλάσσων : ἐλάσσων
ἐλαύνω : ἐλαύνω
ἔλεγος : -
ἐλέγχω : ἐλέγχω
ἐλευθερία : ἐλευθερία
ἐλεύθερος : ἐλεύθερος
ἐλευθερόω : ἐλευθερόω
ἐλπίζω : ἐλπίζω
ἐλπίς : ἐλπίς
ἐμαυτοῦ : ἐμαυτοῦ
ἐμός : ἐμός
ἐν : ἐν
ἐμβάλλω : ἐμβάλλω
ἐνδίδωμι : -  # there's δίδωμι and other derivatives
ἐνθυμέομαι : ἐνθυμέομαι
ἐγκαλέω : ἐγκαλέω
ἐμπίπτω : ἐμπίπτω
ἔμπροσθεν : ἔμπροσθεν
ἐντυγχάνω : ἐντυγχάνω
ἐναντίος : ἐναντίος
ἕνεκα : ἕνεκα
ἔνθα : -  # relation to ἔνθεν?
ἐνθάδε : ἐνθάδε
ἐνιαυτός : ἐνιαυτός
ἔνιοι : -
ἐνίοτε : -
ἐνταῦθα : -
ἐντεῦθεν : ἐντεῦθεν
ἐντός : ἐντός
ἕξ : ἕξ
ἐξετάζω : ἐξετάζω
ἐξαίφνης : ἐξαίφνης
ἑξήκοντα : ἑξήκοντα
ἐξουσία : ἐξουσία
ἔξω : ἔξω
ἕοικα : ἔοικα
ἐπεί : ἐπεί
ἐπείγω : -
ἐπειδάν : -  # relation to ἐπειδή?
ἔπειτα : ἔπειτα
ἐπί : ἐπί
ἐπαγγέλλω : ἐπαγγέλλομαι  # with quite a different gloss
ἐπάγω : ἐπάγω
ἐπαινέω : ἐπαινέω
ἐπανέρχομαι : ἐπανέρχομαι
ἐπιβάλλω : ἐπιβάλλω
ἐπιβουλεύω : -  # although there's ἐπιβουλή
ἐπιγίγνομαι : ἐπιγίνομαι
ἐπιδείκνυμι : ἐπιδείκνυμι
ἐπέρχομαι : ἐπέρχομαι
ἐπέχω : ἐπέχω
ἐπιθυμέω : ἐπιθυμέω
ἐφίστημι : ἐφίστημι
ἐπιμέλεια : ἐπιμέλεια
ἐπιμελέομαι : ἐπιμελέομαι
ἐπιτίθημι : ἐπιτίθημι
ἐπιτρέπω : ἐπιτρέπω
ἐπιφανής : ἐπιφανής
ἐπιφέρω : ἐπιφέρω
ἐπιχειρέω : ἐπιχειρέω
ἐπίσταμαι : ἐπίσταμαι
ἐπιστήμη : -
ἐπιστολή : ἐπιστολή
ἐπιτήδειος : ἐπιτήδειος
ἕπομαι : -
ἔπος : ἔπος
ἐργάζομαι : ἐργάζομαι
ἔργον : ἔργον
ἐρῆμος : ἔρημος  # 3-termination vs 2-termination?
ἔρις : ἔρις
ἔρομαι : -
ἔρχομαι : ἔρχομαι
ἐρῶ : -
ἔρως : -
ἐρωτάω : ἐρωτάω
ἐσθής : ἐσθής
ἐσθίω : ἐσθίω
ἑσπέρα : ἑσπέρα
ἔσχατος : ἔσχατος
ἑταῖρος : ἑταῖρος
ἕτερος : ἕτερος
ἔτης : -
ἔτι : ἔτι
ἕτοιμος : ἕτοιμος
ἔτος : ἔτος
εὖ : εὖ
εὐδαίμων : -
εὐθύς : εὐθύς
εὔνοια : εὔνοια
εὑρίσκω : εὑρίσκω
εὐρύς : -  # there's εὐρύχωρος
εὔχομαι : εὔχομαι
ἐχθρός : ἐχθρός
ἔχω : ἔχω
ἕως : ἕως
ζάω : ζάω
Ζεύς : Ζεύς
ζητέω : ζητέω
ἤ : ἤ
ἦ : -  # also 1st sg impf indic act of εἰμί
ᾖ : -  # 3d sg pres subj act of εἰμί
ἡ : ὁ
ἥ : ὅς
ᾗ : ὅς
ἡγεμών : ἡγεμών
ἡγέομαι : ἡγέομαι
ἥδη : ἤδη
ἥδομαι : -
ἡδονή : ἡδονή
ἡδύς : -
ἥκιστος : -
ἥκω : ἥκω
ἡλικία : ἡλικία
ἥλιος : ἥλιος
ἧμαι : -
ἡμέρα : ἡμέρα
ἡμέτερος : ἡμέτερος
ἠμί : -
ἥμισυς : ἥμισυς
ἤπειρος : -
ἥρως : -
ἡσυχία : ἡσυχία
ἡσσάομαι : -  # there's ἥσσων
ἥσσων : ἥσσων
θάλασσα : θάλασσα
θάνατος : θάνατος
θάπτω : θάπτω
θαρσέω : θαρσέω
θαυμάζω : θαυμάζω
θαυμαστός : θαυμαστός
θεά : θεά
θεάομαι : θεάομαι
θεῖος : θεῖος
θεός : θεός
θεραπεύω : θεραπεύω
θέρμος : θέρμη  # ???
θέω : -
θεωρέω : θεωρέω
θνήσκω : θνῄσκω
θρόνος : θρόνος
θυγάτηρ : θυγάτηρ
θυμός : θυμός
θύρα : θύρα
θυσία : θυσία
θύω : θύω
θώραξ : θώραξ
ἰατρός : ἰατρός
ἴδιος : ἴδιος
ἰδιώτης : ἰδιώτης
ἰδοῦ : ἰδού
ἱδρύω : -
ἱερεύς : ἱερεύς
ἱερόν : ἱερόν
ἱερός : ἱερός
ἵημι : -
ἱκανός : ἱκανός
ἱκνέομαι : -
ἵνα : ἵνα
ἱππεύς : ἱππεύς
ἵππος : ἵππος
ἴσος : ἴσος
ἵστημι : ἵστημι
ἱστορία : -  # there's ἱστορέω
ἰσχυρός : ἰσχυρός
ἰσχύς : ἰσχύς
καθά : καθά
καθαρός : καθαρός
καθό : καθό
καί : καί
καίπερ : καίπερ
καιρός : καιρός
καίτοι : καίτοι
κακός : κακός
καλέω : καλέω
κάλλος : -
καλός : καλός
κάμνω : κάμνω
κἀν : -
κἄν : κἄν
καρδία : καρδία
καρπός : καρπός
κατά : κατά
καταβαίνω : καταβαίνω
καταγιγνώσκω : καταγινώσκω
κατάγω : κατάγω
κάθημαι : κάθημαι
καθίστημι : καθίστημι
καταλαμβάνω : καταλαμβάνω
καταλείπω : καταλείπω
καταλύω : καταλύω
καταπλήσσω : -  # there's πλήσσω
κατασκευάζω : κατασκευάζω
καταστρέφω : καταστρέφω
καταφεύγω : καταφεύγω
καταφρονέω : καταφρονέω
κατέχω : κατέχω
κατηγορέω : κατηγορέω
κατοικέω : κατοικέω
κεῖμαι : κεῖμαι
κελεύω : κελεύω
κενός : κενός
κέρας : κέρας
κεφαλή : κεφαλή
κῆρυξ : κῆρυξ
κινδυνεύω : κινδυνεύω
κίνδυνος : κίνδυνος
κινέω : κινέω
κλέος : κλέος
κλέπτω : κλέπτω
κλίνω : κλίνω
κοινός : κοινός
κολάζω : κολάζω
κόλπος : κόλπος
κομίζω : κομίζω
κόπτω : κόπτω
κόρη : -  # there's κοράσιον
κοσμέω : κοσμέω
κόσμος : κόσμος
κρατέω : κρατέω
κράτιστος : κράτιστος
κράτος : κράτος
κρείσσων : κρείττων
κρίνω : κρίνω
κρίσις : κρίσις
κριτής : κριτής
κρύπτω : κρύπτω
κτάομαι : κτάομαι
κτείνω : -  # there's ἀποκτείνω
κύκλος : -  # there's κυκλόθεν and κυκλόω
κυρέω : -
κύριος : κύριος
κύων : κύων
κωλύω : κωλύω
κώμη : κώμη
λαγχάνω : λαγχάνω
λαλέω : λαλέω
λαμβάνω : λαμβάνω
λαμπρός : λαμπρός
λανθάνω : λανθάνω
λέγω : λέγω
λείπω : λείπω
λευκός : λευκός
λεώς : λαός
λίθος : λίθος
λιμήν : λιμήν
λίμνη : λίμνη
λιμός : λιμός
λογίζομαι : λογίζομαι
λόγος : λόγος
λοιπός : λοιπός
λόφος : -
λυπέω : λυπέω
λύω : λύω
μακρός : μακρός
μάλα : -
μάλιστα : μάλιστα
μᾶλλον : μᾶλλον
μανθάνω : μανθάνω
μανία : μανία
μάντις : -
μαρτυρέω : μαρτυρέω
μαρτυρία : μαρτυρία
μάρτυς : μάρτυς
μάχη : μάχη
μάχομαι : μάχομαι
μέγαρον : -
μέγας : μέγας
μέγεθος : μέγεθος
μέλας : μέλας
μέλει : μέλει
μέλλω : μέλλω
μέν : μέν
μέντοι : μέντοι
μένω : μένω
μέρος : μέρος
μέσος : μέσος
μετά : μετά
μεταβάλλω : μεταβάλλομαι
μεταπέμπω : μεταπέμπομαι
μετέχω : μετέχω
μεταξύ : μεταξύ
μέχρι : μέχρι(ς)
μή : μή
μηδέ : μηδέ
μηδείς : μηδείς
μήτε : μήτε
μῆκος : μῆκος
μήν : μήν/X
μήτηρ : μήτηρ
μηχανή : -
μικρός : μικρός
μιμνήσκω : μιμνῄσκομαι
μισέω : μισέω
μισθός : μισθός
μνᾶ : μνᾶ
μνήμη : μνήμη
μοῖρα : -
μόνος : μόνος
μῦθος : μῦθος
μυριάς : μυριάς
μυρίος : μύριοι
ναί : ναί
ναυμαχία : -
ναῦς : ναῦς
ναυτικός : -  # there's ναῦς, ναύτης, etc
νεανίας : νεανίας
νεκρός : νεκρός
νέμω : -  # there's ἀπονέμω and διανέμω
νέος : νέος
νεώς : ναός
νῆσος : νῆσος
νικάω : νικάω
νίκη : νίκη
νοέω : νοέω
νομίζω : νομίζω
νόμιμος : -  # there's νομίμως
νόμος : νόμος
νοῦς : νοῦς
νόσος : νόσος
νύμφη : νύμφη
νῦν : νῦν
νύξ : νύξ
ξένος : ξένος
ξύλον : ξύλον
ὁ : ὁ
ὅδε : ὅδε
ὁδός : ὁδός
ὅθεν : ὅθεν
οἶδα : οἶδα
οἰκεῖος : οἰκεῖος
οἰκέτης : οἰκέτης
οἰκέω : οἰκέω
οἰκία : οἰκία
οἰκοδομέω : οἰκοδομέω
οἶκος : οἶκος
οἶμαι : οἶμαι
οἷος : οἷος
οἷος : οἷος
οἴχομαι : -
ὀκτώ : ὀκτώ
ὀλίγος : ὀλίγος
ὄλλυμι : -  # there's ἀπόλλυμι
ὅλος : ὅλος
ὄμνυμι : ὀμνύω
ὅμοιος : ὅμοιος
ὁμοιόω : ὁμοιόω
ὁμολογέω : ὁμολογέω
ὁμόω : -
ὅμως : ὅμως
ὄνομα : ὄνομα
ὀνομάζω : ὀνομάζω
ὀξύς : ὀξύς
ὁπλίτης : -
ὅπλον : ὅπλον
ὁποῖος : ὁποῖος
ὁπόσος : -
ὁπότε : ὁπότε
ὅπου : ὅπου
ὅπως : ὅπως
ὁράω : ὁράω
ὀργή : ὀργή
ὀργίζω : ὀργίζομαι
ὀρθός : ὀρθός
ὀρθόω : -  # there's ὀρθός
ὅρκος : ὅρκος
ὁρμάω : ὁρμάω
ὁρμή : ὁρμή
ὄρος : ὄρος
ὅρος : -  # there's ὁροθεσία
ὅς : ὅς
ὅσος : ὅσος
ὅσπερ : -
ὅστε : -
ὅστις : ὅστις
ὅταν : ὅταν
ὅτε : ὅτε
ὅτι : ὅτι
οὐ : οὐ
οὐδέ : οὐδέ
οὐδείς : οὐδείς
οὐκέτι : οὐκέτι
οὔτε : οὔτε
οὔτις : -
οὔπω : οὔπω
οὗ : οὗ
οὐκοῦν : οὐκοῦν
οὖν : οὖν
οὐρανός : οὐρανός
οὐσία : οὐσία
οὗτος : οὗτος
οὕτως : οὕτω(ς)
ὀφείλω : ὀφείλω
ὀφθαλμός : ὀφθαλμός
ὄφρα : -
ὄχλος : ὄχλος
ὄψις : ὄψις
πάθος : πάθος
παιδεύω : παιδεύω
παῖς : παῖς
παλαιός : παλαιός
πάλιν : πάλιν
παντάπασι : -
πάντῃ : πάντῃ
πάνυ : -
παρά : παρά
παραγγέλλω : παραγγέλλω
παραγίγνομαι : παραγίνομαι
παραδίδωμι : παραδίδωμι
παράδοξος : παράδοξος
πάρειμι : πάρειμι
πάρεστι : πάρειμι  # ?
παρέρχομαι : παρέρχομαι
παρέχω : παρέχω
παρίστημι : παρίστημι
παρακαλέω : παρακαλέω
παραλαμβάνω : παραλαμβάνω
παραπλήσιος : παραπλήσιον
παρασκευάζω : παρασκευάζω
παρασκευή : παρασκευή
παραχρῆμα : παραχρῆμα
παρθένος : παρθένος
πᾶς : πᾶς
πάσσω : -
πάσχω : πάσχω
πατήρ : πατήρ
πάτριος : -
πατρίς : πατρίς
παύω : παύω
πεδίον : -
πεζός : πεζῇ
πείθω : πείθω
πειράζω : πειράζω
πειράω : πειράω
πέλας : -
πέμπω : πέμπω
πεντακόσιοι : πεντακόσιοι
πέντε : πέντε
πεντήκοντα : πεντήκοντα
πέρ : -
περάω : -  # there's διαπεράω
πέρθω : -  # related to πορθέω?
περί : περί
περίειμι : -
περιίστημι : περιΐστημι
πέτρα : πέτρα
πηρός : -
πίμπλημι : πίμπλημι
πίνω : πίνω
πίπτω : πίπτω
πιστεύω : πιστεύω
πίστις : πίστις
πιστός : πιστός
πλεῖστος : -
πλείων : -
πλέω : πλέω
πλέως : -
πλῆθος : πλῆθος
πλήν : πλήν
πληρόω : πληρόω
πλησίος : -  # there's πλησίον
πλήσσω : πλήσσω
πλοῖον : πλοῖον
πλούσιος : πλούσιος
πλοῦτος : πλοῦτος
πνεῦμα : πνεῦμα
ποιέω : ποιέω
ποιητής : ποιητής
ποῖος : ποῖος
πολεμέω : πολεμέω
πολέμιος : -
οἱ πολέμιοι : -
πόλεμος : πόλεμος
πολιορκέω : -
πολιορκία : -
πόλις : πόλις
πολιτεία : πολιτεία
πολιτεύω : πολιτεύομαι
πολίτης : πολίτης
πολιτικός : -  # there's πολίτης, etc
πολλάκις : πολλάκις
πολύς : πολύς
πονηρός : πονηρός
πόνος : πόνος
πορεία : πορεία
πορεύω : πορεύομαι
πορθέω : πορθέω
πόρρω : πόρρω
ποταμός : ποταμός
ποτέ : ποτέ
πότερος : πότερον
ποτός : -  # there's the noun πότος
πού : πού
πούς : πούς
πρᾶγμα : πρᾶγμα
πρᾶξις : πρᾶξις
πράσσω : πράσσω
πρεσβευτής : πρεσβύτης  # just accent difference
πρεσβεύω : πρεσβεύω
πρέσβυς : -  # plenty of cognates: πρεσβεύω, πρεσβεία, πρεσβύτης, etc
πρίν : πρίν
πρό : πρό
προάγω : προάγω
προαίρεσις : -  # there's προαιρέομαι
προαιρέω : προαιρέομαι
πρόγονος : πρόγονος
προδίδωμι : προδίδωμι
προερέω : -  # although there's προλέγω with a different meaning
προέρχομαι : προέρχομαι
προθέω : -
προθυμία : προθυμία
πρόθυμος : πρόθυμος
προίημι : -
προίστημι : προΐστημι  # quite different gloss, though
πρόνοια : πρόνοια
πρός : πρός
προσαγορεύω : προσαγορεύω
προσάγω : προσάγω
προσδέχομαι : προσδέχομαι
πρόσειμι : -
προσέρχομαι : προσέρχομαι
προσέχω : προσέχω
προσήκω : -
πρόσθεν : -
προσλαμβάνω : προσλαμβάνομαι
προσπίπτω : προσπίπτω
προστάσσω : προστάσσω
προστίθημι : προστίθημι
προσφέρω : προσφέρω
πρόσωπον : πρόσωπον
πρότερος : πρότερος
πρόφασις : πρόφασις
προφήτης : προφήτης
πρῶτος : πρῶτος
πτερόν : -  # NT equivalent seems to be πτέρυξ
πύλη : πύλη
πυνθάνομαι : πυνθάνομαι
πῦρ : πῦρ
πωλέω : πωλέω
πώποτε : πώποτε
πως : πώς
πῶς : πῶς
ῥᾴδιος : -  # although there's ῥᾳδιουργία
ῥέω : ῥέω
ῥήτωρ : ῥήτωρ
ῥύθμος : -
ῥώμη : -  # although there's Ῥώμη (Rome)
σαυτοῦ : σεαυτοῦ
σαφής : -  # there's διασαφέω
σελήνη : σελήνη
σημαίνω : σημαίνω
σημεῖον : σημεῖον
σῖτος : σῖτος
σκέπτομαι : -  # there's ἐπισκέπτομαι
σκευάζω : -  # there's ἀνασκευάζω, ἐπισκευάζομαι, κατασκευάζω, παρασκευάζω
σκήνη : σκηνή  # also σκῆνος, etc
σκοπέω : σκοπέω
σός : σός
σοφία : σοφία
σοφός : σοφός
σπεύδω : σπεύδω
σπονδή : -
σπουδάζω : σπουδάζω
σπουδή : σπουδή
στάδιον : στάδιον
στάσις : στάσις
στέλλω : στέλλομαι  # with a different gloss, though
στερέω : -  # there's ἀποστερέω
στέρνον : -
στεφανόω : στεφανόω
στόλος : -  # there's στέλλομαι, etc
στόμα : στόμα
στρατεία : στρατεία
στράτευμα : στράτευμα
στρατεύω : στρατεύομαι
στρατηγός : στρατηγός
στρατιά : στρατιά
στρατιώτης : στρατιώτης
στρατοπεδεύω : -  # there's στρατόπεδον
στρατόπεδον : στρατόπεδον
στρατός : -  # there's στρατεία, στράτευμα, στρατιά, etc
στρέφω : στρέφω
σύ : σύ
σύν : σύν
συνάγω : συνάγω
συνάπτω : -
συγγενής : συγγενής
συγγνώμη : συγγνώμη
σύγκλητος : -
συλλαμβάνω : συλλαμβάνω
συμβαίνω : συμβαίνω
συμβάλλω : συμβάλλω
συμβουλεύω : συμβουλεύω
σύνειμι : σύνειμι
συνέρχομαι : συνέρχομαι
συνεχής : -  # there's συνέχω
συνθήκη : -  # there's θήκη, ἀποθήκη, διαθήκη, etc
συνίστημι : συνίστημι
συμμαχέω : -  # there are some μαχ derivatives such as ἄμαχος, θηριομαχέω, λογομαχέω, etc
συμμαχία : -  # ditto, also λογομαχία
σύμμαχος : -  # ditto
σύμπας : -
συμφέρω : συμφέρω
συμφορά : -  # there's σύμφορον
συντάσσω : συντάσσω
συντίθημι : συντίθεμαι
συγχωρέω : -
σφάζω : σφάζω
σφεῖς : -
σφέτερος : -
σφόδρα : σφόδρα
σχεδόν : σχεδόν
σχῆμα : σχῆμα
σχολή : σχολή
σώζω : σῴζω
σῶμα : σῶμα
σωτηρία : σωτηρία
τάλαντον : τάλαντον
τάξις : τάξις
τάσσω : τάσσω
ταύτῃ : -
ταῦρος : ταῦρος
ταὐτό : -
τάφος : τάφος
τάχος : τάχος
ταχύς : ταχύς
τε : τέ
τείνω : -  # there's ἐκτείνω, παρατείνω, προτείνω, ὑπερεκτείνω
τειχέω : -  # there's τεῖχος
τεῖχος : τεῖχος
τεκμήριον : τεκμήριον
τέκνον : τέκνον
τελευταῖος : -  # there's τελευτή, τελευτάω
τελευτάω : τελευτάω
τελευτή : τελευτή
τελέω : τελέω
τέλος : τέλος
τέμνω : -  # there's περιτέμνω
τεσσαράκοντα : τεσσεράκοντα
τέσσαρες : τέσσαρες
τέταρτος : τέταρτος
τετρακόσιοι : τετρακόσιοι
τεύχω : -
τέχνη : τέχνη
τῇ : -
τηλικοῦτος : τηλικοῦτος
τηρέω : τηρέω
τίθημι : τίθημι
τίκτω : τίκτω
τιμάω : τιμάω
τιμή : τιμή
τιμωρέω : τιμωρέω
τιμωρία : τιμωρία
τις : τις
τίς : τίς
τοι : -  # although there are compounds like τοιγαροῦν, τοίνυν
τοίνυν : τοίνυν
τοιόσδε : τοιόσδε
τοιοῦτος : τοιοῦτος
τολμάω : τολμάω
τόξον : τόξον
τόπος : τόπος
τοσόσδε : -
τοσοῦτος : τοσοῦτος
τότε : τότε
τραῦμα : τραῦμα
τρεῖς : τρεῖς
τρέπω : -  # there's ἀνατρέπω, ἀποτρέπομαι, ἐκτρέπομαι, ἐντρέπω, etc
τρέφω : τρέφω
τρέχω : τρέχω
τρέω : -
τριάκοντα : τριάκοντα
τριακόσιοι : τριακόσιοι
τρίβω : -  # there's διατρίβω and συντρίβω but not that transparent
τριήρης : -
τρίτος : τρίτος
τρόπος : τρόπος
τροφή : τροφή
τυγχάνω : τυγχάνω
τυραννίς : -
τύραννος : -  # although there's Τύραννος
τύχη : -  # although there's τυγχάνω
ὑβρίζω : ὑβρίζω
ὕβρις : ὕβρις
ὑγιής : ὑγιής
ὕδωρ : ὕδωρ
υἱός : υἱός
ὑμέτερος : ὑμέτερος
ὕπατος : -
ὑπέρ : ὑπέρ
ὑπερβάλλω : ὑπερβάλλω
ὑπερβολή : ὑπερβολή
ὑπισχνέομαι : -
ὕπνος : ὕπνος
ὑπό : ὑπό
ὑπακούω : ὑπακούω
ὑπάρχω : ὑπάρχω
ὑπολαμβάνω : ὑπολαμβάνω
ὑπομένω : ὑπομένω
ὕστερος : ὕστερος
ὑψηλός : ὑψηλός
φαίνω : φαίνω
φάλαγξ : -
φανερός : φανερός
φάρμακον : φάρμακον
φάσκω : φάσκω
φαῦλος : φαῦλος
φέρω : φέρω
φεύγω : φεύγω
φημί : φημί
φθάνω : φθάνω
φθείρω : φθείρω
φιλέω : φιλέω
φιλία : φιλία
φίλιος : -  # there's φιλία
φίλος : φίλος
φοβέω : φοβέομαι
φόβος : φόβος
φόνος : φόνος
φράζω : φράζω
φρήν : φρήν
φρονέω : φρονέω
φροντίζω : φροντίζω
φρουρά : -
φυγάς : -  # there's φυγή
φυγή : φυγή
φυλακή : φυλακή
φυλάσσω : φυλάσσω
φυλή : φυλή
φύσις : φύσις
φύω : φύω
φωνέω : φωνέω
φωνή : φωνή
φῶς : φῶς
χαίρω : χαίρω
χαλεπός : χαλεπός
χάρις : χάρις
χειμών : χειμών
χείρ : χείρ
χειρόω : -  # there's χείρ
χείρων : χείρων
χέω : -  # there's ἐκχέω, ἐπιχέω, καταχέω, etc
χίλιοι : χίλιοι
χόω : -
χράομαι : χράομαι
χράω : -  # there's χράομαι but Major treats that distinctly
χρεία : χρεία
χρή : χρή
χρῆμα : χρῆμα
τὰ χρήματα : χρῆμα
χρήσιμος : χρήσιμον
χρηστός : χρηστός
χρόνος : χρόνος
χρυσοῦς : χρυσοῦς
χρυσός : χρυσός
χώρα : χώρα
χωρέω : χωρέω
χωρίον : χωρίον
χωρίς : χωρίς
ψευδής : ψευδής
ψεύδω : ψεύδομαι
ψηφίζω : ψηφίζω
ψήφισμα : -  # there's ψηφίζω
ψῆφος : ψῆφος
ψυχή : ψυχή
ὦ : ὦ
ὧδε : ὧδε
ὥρα : ὥρα
ὡς : ὡς
ὥσπερ : ὥσπερ
ὥστε : ὥστε
ὠφελέω : ὠφελέω